id,lat,lng,planningArea,tap_in,tap_out,deficit,avg_flow,pop_multiplier,pop_estimate
75009,1.35407552367477,103.94339098473914,TAMPINES,4607736,4502560,105176,4555148,0.19012510200892468,49413
76059,1.35296163572491,103.94165154852797,TAMPINES,330559,116454,214105,223506,0.00932880798815027,2424
76069,1.34875342114003,103.94208629087403,TAMPINES,310013,204128,105885,257070,0.010729719423701331,2788
96289,1.34005496226354,103.94838106593957,TAMPINES,144639,312525,-167886,228582,0.009540672677902897,2479
96109,1.33737118239889,103.95067333143491,TAMPINES,74787,104606,-29819,89696,0.0037437776225476118,973
85079,1.33394889968504,103.9501523198666,TAMPINES,51519,36454,15065,43986,0.001835910213447414,477
85089,1.33338002405472,103.94880327361744,BEDOK,23668,11898,11770,17783,0.0007242020775880532,97
85069,1.3318,103.94738,BEDOK,98445,67706,30739,83075,0.003383179868167774,454
85059,1.32950222197902,103.94906611097686,BEDOK,15080,5885,9195,10482,0.0004268732034683672,57
85049,1.32671998700111,103.95124872703616,BEDOK,25770,80074,-54304,52922,0.0021552169122259998,289
85039,1.32442497435966,103.95298594261581,BEDOK,3473,25774,-22301,14623,0.0005955129607248553,79
85029,1.32261805599904,103.95429972202514,BEDOK,5746,28787,-23041,17266,0.0007031475606835363,94
85019,1.321288333018,103.95534472201146,BEDOK,25211,75808,-50597,50509,0.002056948925203564,276
94079,1.31962000617397,103.95524325955397,BEDOK,5113,14374,-9261,9743,0.00039677786886016997,53
94069,1.31809668590525,103.95085659912792,BEDOK,18917,8039,10878,13478,0.0005488835180639814,73
94059,1.31707137658578,103.94798092494041,BEDOK,101954,43235,58719,72594,0.002956347389103477,396
94049,1.31616443335073,103.94482108127718,BEDOK,21185,13336,7849,17260,0.0007029032142591126,94
94089,1.31536333302999,103.94294138900047,BEDOK,23098,11366,11732,17232,0.0007017629309451349,94
94039,1.31485363967239,103.94066333773824,BEDOK,111534,46928,64606,79231,0.003226635258920263,433
94029,1.31453305602342,103.93750499997167,BEDOK,33413,11816,21597,22614,0.0009209416736532776,123
94019,1.3142851610342,103.93574953076752,BEDOK,37614,11279,26335,24446,0.000995548781910676,133
93099,1.31390444400831,103.93171138898548,BEDOK,33376,33652,-276,33514,0.0013648376780231691,183
93089,1.31295810131062,103.92790605020116,BEDOK,46125,47829,-1704,46977,0.0019131103300260909,256
93079,1.31250502315071,103.9250247698478,BEDOK,58077,55832,2245,56954,0.002319417709438789,311
93069,1.31168943552207,103.92240015622043,BEDOK,71377,51333,20044,61355,0.002498645811753641,335
93059,1.31076138897412,103.91930777802244,BEDOK,25348,21789,3559,23568,0.0009597927551366607,128
92159,1.309748,103.9166295,BEDOK,60383,49918,10465,55150,0.002245950884495368,301
92149,1.30928064742874,103.91434517290193,BEDOK,48989,24567,24422,36778,0.0014977621329097127,201
92139,1.30853972762017,103.91062932209371,BEDOK,44486,28490,15996,36488,0.0014859520557292292,199
92129,1.30686400495083,103.90646134135645,MARINE PARADE,74892,90789,-15897,82840,0.021076563594027323,516
92119,1.30444500073,103.90277451423108,MARINE PARADE,167700,118820,48880,143260,0.036448919609854594,893
92109,1.30356602776936,103.90145614778639,MARINE PARADE,45024,15440,29584,30232,0.0076917753570091025,188
92099,1.3023783312326,103.89900426571224,MARINE PARADE,81612,50986,30626,66299,0.01686812034911175,413
92161,1.30380001918907,103.89656923070308,MARINE PARADE,84796,52715,32081,68755,0.01749298804813313,428
82071,1.30725334418948,103.89541128171984,MARINE PARADE,148969,46696,102273,97832,0.024890902577630145,610
81199,1.30862937328019,103.8906311270188,MARINE PARADE,10539,24933,-14394,17736,0.004512481070783059,110
81189,1.30821308595952,103.88850877408412,GEYLANG,79795,353111,-273316,216453,0.01445715874581862,807
81179,1.30726086825664,103.88490711001795,GEYLANG,91355,88964,2391,90159,0.006021829105460589,336
80141,1.30711835522323,103.87989373246151,KALLANG,73795,80844,-7049,77319,0.007852037747951204,402
80219,1.30674381370885,103.875264139574,KALLANG,10878,11825,-947,11351,0.0011527371083044802,59
80169,1.30070547633658,103.86336013257065,DOWNTOWN CORE,35565,60688,-25123,48126,0.010024986434001548,15
80159,1.295962316986,103.85795174896221,DOWNTOWN CORE,63197,88600,-25403,75898,0.01581009060316356,25
02119,1.29184407356581,103.85534334305085,DOWNTOWN CORE,20373,29736,-9363,25054,0.005218925531261164,8
03019,1.284245000013,103.85310805599599,DOWNTOWN CORE,72528,193165,-120637,132846,0.0276727620789463,43
03059,1.281111,103.851461,DOWNTOWN CORE,83482,179664,-96182,131573,0.027407587168700613,43
03129,1.27807003532092,103.84956718123823,DOWNTOWN CORE,145810,250314,-104504,198062,0.041257716475319256,65
03217,1.27552218897645,103.8479443674916,DOWNTOWN CORE,33504,29385,4119,31444,0.006550007759438654,10
05649,1.2723842122117,103.84093912218094,BUKIT MERAH,57026,55803,1223,56414,0.0032875707111214634,497
14061,1.27231269789239,103.83862035734883,BUKIT MERAH,20172,17029,3143,18600,0.0010839297909536502,163
14071,1.27220342411953,103.8339025862589,BUKIT MERAH,10558,8284,2274,9421,0.0005490162666975451,83
14081,1.270896111,103.8308919,BUKIT MERAH,806,1073,-267,939,5.472097170459556e-05,8
14101,1.26837500002503,103.82825805600972,BUKIT MERAH,6726,6291,435,6508,0.00037925887524335245,57
14141,1.26552421466644,103.82211326846237,BUKIT MERAH,571215,684673,-113458,627944,0.03659393594895693,5534
14121,1.26591350024271,103.81925660621779,BUKIT MERAH,202044,75881,126163,138962,0.008098121054328018,1224
14131,1.26740130257465,103.81675441150337,BUKIT MERAH,80970,95747,-14777,88358,0.005149132713391538,778
14151,1.26964765905364,103.8129359412343,BUKIT MERAH,49657,43165,6492,46411,0.0027046379316102076,409
14161,1.27075866533548,103.81009913005327,BUKIT MERAH,174888,197518,-22630,186203,0.010851127895964652,1641
14171,1.27145959833005,103.80654857059398,BUKIT MERAH,12748,7049,5699,9898,0.0005768138210139371,87
15141,1.27275860463579,103.80095947823813,QUEENSTOWN,22462,21892,570,22177,0.0019259079913240785,184
15151,1.27389192906939,103.79822208982421,QUEENSTOWN,40610,53444,-12834,47027,0.004083946210398045,391
15161,1.27443806198132,103.79666055940478,QUEENSTOWN,56204,61871,-5667,59037,0.0051269256474635715,491
15191,1.27581227029734,103.79263571257981,QUEENSTOWN,96395,101820,-5425,99107,0.008606707999105173,825
15201,1.27680819120105,103.78970861437152,QUEENSTOWN,6816,10501,-3685,8658,0.0007518830945972797,72
15221,1.27949923466491,103.78548955401584,QUEENSTOWN,53800,50670,3130,52235,0.004536222389268757,435
16201,1.28130063164133,103.78410758834183,QUEENSTOWN,11564,10242,1322,10903,0.0009468446962802195,90
16011,1.28277766355314,103.78186930413443,QUEENSTOWN,239833,46307,193526,143070,0.01242456853130432,1191
16021,1.28625793147796,103.77981027693801,QUEENSTOWN,6742,11689,-4947,9215,0.0008002544140348733,76
16031,1.28800629048399,103.77846479413628,QUEENSTOWN,19831,87207,-67376,53519,0.004647728267469601,445
16041,1.2893086506189,103.77660095143266,QUEENSTOWN,48002,40025,7977,44013,0.0038222026614125747,366
16051,1.29014861601908,103.77426036615236,QUEENSTOWN,11203,16545,-5342,13874,0.0012048540141421412,115
16061,1.29046257201356,103.77356171611027,QUEENSTOWN,61488,64789,-3301,63138,0.005483067085548977,525
16071,1.29129940835907,103.77117221155989,QUEENSTOWN,15401,14701,700,15051,0.001307067735826248,125
16081,1.29195777797363,103.76866138900287,QUEENSTOWN,45099,40773,4326,42936,0.0037286731981553247,357
16009,1.29425341056334,103.76988323197696,QUEENSTOWN,86242,94706,-8464,90474,0.007856995969114608,753
16089,1.29201138346787,103.76908420716119,QUEENSTOWN,46265,37277,8988,41771,0.0036275015874824403,347
16079,1.29138264862382,103.77129836184207,QUEENSTOWN,19076,26988,-7912,23032,0.002000158400873706,191
16069,1.290648611,103.7736967,QUEENSTOWN,78525,61569,16956,70047,0.006083062500260528,583
16059,1.28967266173408,103.77594136139503,QUEENSTOWN,18332,22404,-4072,20368,0.0017688097563822352,169
16049,1.28910696351866,103.77738952047318,QUEENSTOWN,51645,51141,504,51393,0.004463100933314622,428
16039,1.28799020188116,103.77872029260048,QUEENSTOWN,80120,20265,59855,50192,0.004358802989608069,418
16029,1.28608472200879,103.78022138902949,QUEENSTOWN,10598,9720,878,10159,0.0008822338135844034,84
16019,1.28278078585184,103.78217614858187,QUEENSTOWN,84531,255318,-170787,169924,0.0147566392892525,1415
16209,1.28159092769912,103.78400650244838,QUEENSTOWN,8178,11136,-2958,9657,0.0008386388362815812,80
15229,1.27937638961898,103.78572727156029,QUEENSTOWN,45207,52329,-7122,48768,0.004235139149609626,406
15219,1.27818114088895,103.78701031206879,QUEENSTOWN,20636,19948,688,20292,0.001762209719977824,169
15209,1.27706561928684,103.79023432729963,QUEENSTOWN,20587,30398,-9811,25492,0.002213791158174388,212
15199,1.27604240853686,103.79318399639808,QUEENSTOWN,70764,34609,36155,52686,0.0045753883947738825,438
15169,1.27481499269165,103.79673994290195,QUEENSTOWN,75790,57431,18359,66610,0.005784584538129452,554
15159,1.27426303773784,103.79839350407595,QUEENSTOWN,51061,43783,7278,47422,0.00411824903118413,395
15149,1.27341871854745,103.80055546758587,QUEENSTOWN,29486,27665,1821,28575,0.0024815268454743897,238
14189,1.27269303340787,103.80398363214624,BUKIT MERAH,21135,14916,6219,18025,0.001050421208706427,158
14179,1.27188454577735,103.80630000533797,BUKIT MERAH,16035,23037,-7002,19536,0.001138475935272608,172
14169,1.27118550385957,103.80941810434497,BUKIT MERAH,207935,135285,72650,171610,0.010000709216427737,1512
14159,1.26994046445496,103.81315419081787,BUKIT MERAH,61790,73041,-11251,67415,0.003928662734254856,594
14139,1.2686352773503,103.81546952380809,BUKIT MERAH,42696,74789,-32093,58742,0.0034232367623763076,517
14129,1.26607869101924,103.81977877391114,BUKIT MERAH,294859,484717,-189858,389788,0.022715205664314054,3435
14119,1.26592360897281,103.8222827803663,BUKIT MERAH,342981,51644,291337,197312,0.011498513704981,1739
14109,1.26804601553507,103.82722490505579,BUKIT MERAH,13472,3204,10268,8338,0.0004859035804823406,73
14089,1.27046005041763,103.829792773326,BUKIT MERAH,1769,1711,58,1740,0.0001013998836698576,15
14069,1.272538056,103.8364069,BUKIT MERAH,16273,17117,-844,16695,0.0009729144010737199,147
05641,1.27272393115133,103.84140618785226,BUKIT MERAH,64407,47946,16461,56176,0.003273701071860874,495
03222,1.27397836925637,103.84489562922414,DOWNTOWN CORE,75600,38845,36755,57222,0.011919747615144341,18
03111,1.2778259536079,103.8481011719729,DOWNTOWN CORE,141473,99697,41776,120585,0.02511870899605362,39
03071,1.27990609626764,103.84940030424481,DOWNTOWN CORE,64020,51410,12610,57715,0.01202244300457963,19
03031,1.28207492207952,103.85086074925066,DOWNTOWN CORE,106278,62290,43988,84284,0.0175569537589533,27
03011,1.28561840945474,103.85342223246427,DOWNTOWN CORE,181070,62345,118725,121707,0.02535242953752704,40
02111,1.29095592348389,103.85453419435228,DOWNTOWN CORE,26516,32258,-5742,29387,0.00612152010007072,9
80151,1.296265,103.857666,DOWNTOWN CORE,50671,38018,12653,44344,0.00923716906514908,14
80161,1.30032715605093,103.8624541086332,DOWNTOWN CORE,47681,53393,-5712,50537,0.010527214798968046,16
80211,1.30712803633755,103.87548108759093,KALLANG,12907,21672,-8765,17289,0.0017557635332108323,90
80149,1.3074963710946,103.8798058337351,GEYLANG,92018,88872,3146,90445,0.006040931392799199,337
81171,1.30751703730041,103.88500750064323,GEYLANG,172087,174373,-2286,173230,0.011570242082753113,646
81181,1.30845544825732,103.88847214403829,GEYLANG,327581,91001,236580,209291,0.013978800067779724,780
81191,1.30913166702397,103.89180000002517,GEYLANG,5285,11935,-6650,8610,0.0005750723565924164,32
82079,1.30801114591342,103.8951960850957,MARINE PARADE,66999,160957,-93958,113978,0.02899884796378617,711
92169,1.303782,103.8967661,MARINE PARADE,50907,90554,-39647,70730,0.01799547734193086,441
92091,1.30270333303256,103.89931388900563,MARINE PARADE,13617,29181,-15564,21399,0.0054444396951785455,133
92101,1.30370246223719,103.90129169936806,MARINE PARADE,68946,111298,-42352,90122,0.02292928614462736,562
92111,1.30477657929676,103.90293341562067,MARINE PARADE,119225,156573,-37348,137899,0.0350849474052725,860
92121,1.30722207111074,103.90676515165585,MARINE PARADE,97630,89463,8167,93546,0.023800437203849348,583
92131,1.30878111099591,103.91089222198016,BEDOK,28332,44276,-15944,36304,0.001478458765380233,198
92141,1.30939538245506,103.91428724575974,BEDOK,27653,45659,-18006,36656,0.0014927937556130956,200
92151,1.3098029425373,103.91602380242344,BEDOK,52855,44758,8097,48806,0.0019875952650712774,266
93051,1.31065440276409,103.91866922380741,BEDOK,20226,22734,-2508,21480,0.0008747601994371806,117
93061,1.31199515605411,103.92260670662348,BEDOK,77469,90887,-13418,84178,0.003428098885857681,460
93071,1.31293014528666,103.92634861688488,BEDOK,56278,64364,-8086,60321,0.0024565367779446077,329
93081,1.31342707975776,103.92903327944508,BEDOK,38489,33148,5341,35818,0.0014586667050019058,195
93091,1.31398835332345,103.93157431388184,BEDOK,25419,25886,-467,25652,0.0010446624132198583,140
94011,1.31438169513219,103.9351058006447,BEDOK,13034,42116,-29082,27575,0.001122975442247684,150
94021,1.31475174256228,103.93834590911955,BEDOK,12179,38128,-25949,25153,0.0010243409355886128,137
94031,1.31504670788151,103.94089937209914,BEDOK,44493,120566,-76073,82529,0.0033609443435452086,451
94041,1.31619439069366,103.94430577752213,BEDOK,15174,26829,-11655,21001,0.0008552532098873478,114
94051,1.31710244970995,103.94737959133388,BEDOK,72990,132863,-59873,102926,0.004191600013373894,562
94061,1.31843666702467,103.95138333302127,BEDOK,10699,30890,-20191,20794,0.0008468232582447268,113
94071,1.31990193658073,103.95514880285305,BEDOK,30091,10616,19475,20353,0.000828863796049578,111
85021,1.32190305598591,103.95468472199643,BEDOK,83813,25325,58488,54569,0.0022222900057303307,298
85031,1.32501115145725,103.95232021806196,BEDOK,34674,4788,29886,19731,0.0008035332167176447,107
85041,1.3264647104527,103.95116420801885,BEDOK,79066,25020,54046,52043,0.002119420161047914,284
85051,1.32956968334939,103.94880115987219,BEDOK,17466,43939,-26473,30702,0.0012503206537765512,167
85061,1.33146,103.94739,BEDOK,45431,81457,-36026,63444,0.002583719091857192,346
85081,1.33292331447242,103.94719977411023,BEDOK,11634,24910,-13276,18272,0.0007441163111785924,99
85071,1.33407653133395,103.9498516702887,TAMPINES,20494,49580,-29086,35037,0.001462392264551381,380
96101,1.33638500905398,103.9510568939649,TAMPINES,150367,98121,52246,124244,0.005185759754457339,1347
96281,1.33941652681162,103.94850088671714,TAMPINES,207025,102849,104176,154937,0.006466839920449734,1680
76061,1.3482019444416,103.94189805552267,TAMPINES,234054,321801,-87747,277927,0.011600259580157311,3014
76051,1.35313809279079,103.9412639409046,TAMPINES,174496,420819,-246323,297657,0.0124237604329586,3228
66009,1.35046610176969,103.87168992264617,SERANGOON,1076626,541021,535605,808823,0.08213824301870176,9601
62129,1.34698958928417,103.87205488524701,SERANGOON,49809,59384,-9575,54596,0.005544376848641843,648
62119,1.34483265931476,103.8710922003054,SERANGOON,28165,40538,-12373,34351,0.0034884403459538417,407
61049,1.34196277802503,103.8709686110327,TOA PAYOH,22475,20510,1965,21492,0.0016219678382161796,197
61039,1.33845332842129,103.87084881783568,TOA PAYOH,312443,136583,175860,224513,0.016943647183204406,2064
70069,1.337778056,103.8736111,TOA PAYOH,26527,35203,-8676,30865,0.0023293335811717096,283
70059,1.33477611102342,103.87831166701761,TOA PAYOH,134173,215264,-81091,174718,0.01318569592208517,1606
70049,1.33290666703267,103.87871499999147,TOA PAYOH,68248,41147,27101,54697,0.004127897582677758,502
70039,1.32930256265165,103.87975573742911,GEYLANG,119289,183338,-64049,151313,0.010106379035199571,564
70029,1.32662552821417,103.88054354805391,GEYLANG,23198,22236,962,22717,0.0015172960191300725,84
70019,1.32322990499562,103.88145725676175,GEYLANG,127286,121476,5810,124381,0.00830755804707565,464
81099,1.31982276662398,103.88194665985091,GEYLANG,116296,71481,44815,93888,0.006270893544221695,350
81089,1.31628194302502,103.88202243551633,GEYLANG,243373,498018,-254645,370695,0.024759169248202765,1383
80089,1.31274483593155,103.88080516731976,GEYLANG,249958,273167,-23209,261562,0.0174700436393758,975
80069,1.31214703288286,103.87715016317217,GEYLANG,394103,232486,161617,313294,0.020925286746372184,1168
80049,1.31077707819718,103.87363663982293,KALLANG,228501,232467,-3966,230484,0.023406524506250536,1199
80039,1.30992336177794,103.87144344651483,KALLANG,28529,20305,8224,24417,0.0024796389722024927,127
80029,1.3094187398083,103.86753497349068,KALLANG,34505,37099,-2594,35802,0.0036358289094808385,186
01339,1.30774601733202,103.8642627465441,KALLANG,32561,61125,-28564,46843,0.0047570843418471296,243
01349,1.30568635716829,103.86543994417883,KALLANG,2694,2214,480,2454,0.00024921300887844195,12
01429,1.3032136089394,103.86501584807763,DOWNTOWN CORE,33854,56214,-22360,45034,0.009380900948942894,14
01419,1.3020199999911,103.86326333301203,KALLANG,17757,14102,3655,15929,0.0016176503742561946,82
01529,1.30041667676526,103.86044115259938,ROCHOR,42288,29541,12747,35914,0.00926463357566771,60
01519,1.29907492488417,103.8589102973441,DOWNTOWN CORE,25920,33297,-7377,29608,0.006167555964300333,9
01629,1.297085,103.856894,DOWNTOWN CORE,8971,20798,-11827,14884,0.0031004425483871305,4
01619,1.29428694178246,103.85503809424233,DOWNTOWN CORE,10653,28135,-17482,19394,0.004039907469995969,6
02029,1.290106,103.85464,DOWNTOWN CORE,8273,32521,-24248,20397,0.004248839469191904,6
15041,1.274632,103.801892,BUKIT MERAH,184496,91714,92782,138105,0.008048178697830852,1217
15051,1.276978,103.8023815,QUEENSTOWN,90558,76361,14197,83459,0.007247795240470589,695
18011,1.28087089714667,103.8021033300325,QUEENSTOWN,51782,28754,23028,40268,0.0034969771833267796,335
11511,1.2859468736223,103.80251884462385,BUKIT MERAH,177631,189351,-11720,183491,0.010693083939348183,1617
11021,1.28941805603102,103.80228694398484,QUEENSTOWN,150647,106733,43914,128690,0.011175772169522282,1072
11031,1.29119666696879,103.80045500000118,QUEENSTOWN,48928,23722,25206,36325,0.0031545568735558078,302
11041,1.29624499998226,103.79952333299494,QUEENSTOWN,53840,26329,27511,40084,0.0034809981478213627,333
11051,1.29872166703909,103.8002979755481,QUEENSTOWN,108536,56276,52260,82406,0.0071563499992357855,686
11161,1.30213305598263,103.79839083302141,QUEENSTOWN,385493,619243,-233750,502368,0.04362693537383301,4185
11171,1.30535666699303,103.79479722196947,QUEENSTOWN,39128,103390,-64262,71259,0.006188315712394035,593
11181,1.30722333300814,103.79227638896938,QUEENSTOWN,117820,99045,18775,108432,0.00941651509740959,903
11351,1.30934571218561,103.78945112775229,QUEENSTOWN,9003,78602,-69599,43802,0.0038038788761319063,364
11009,1.3110673548964,103.78932237623975,QUEENSTOWN,180119,124993,55126,152556,0.013248357285675976,1270
11359,1.30931022636473,103.78968608347117,QUEENSTOWN,16575,1245,15330,8910,0.0007737674258329594,74
11189,1.30740138898924,103.79254222202354,QUEENSTOWN,252665,219732,32933,236198,0.020512044719067715,1967
11179,1.30627521395682,103.79427940117534,QUEENSTOWN,173299,76324,96975,124811,0.010838909785144499,1039
11169,1.30270500001823,103.79838166697326,QUEENSTOWN,731211,463974,267237,597592,0.051896433618223325,4978
11059,1.29882892782979,103.80097389222824,QUEENSTOWN,90350,148664,-58314,119507,0.010378296718184004,995
11049,1.2954609366563,103.79952549937242,QUEENSTOWN,23850,57885,-34035,40867,0.003548995891303653,340
11039,1.29245762862665,103.79998683928974,QUEENSTOWN,31985,47682,-15697,39833,0.0034592006591699516,331
11029,1.29013472201419,103.80202111098815,QUEENSTOWN,151548,175244,-23696,163396,0.014189730899147275,1361
11519,1.28665742231261,103.80334129425303,QUEENSTOWN,205872,247776,-41904,226824,0.019697982334134136,1889
18019,1.28091055556275,103.80252305556165,BUKIT MERAH,44213,66564,-22351,55388,0.003227779745233375,488
15059,1.27686194443878,103.80270111113056,BUKIT MERAH,54037,97040,-43003,75538,0.004402037018766496,665
15049,1.274590541032,103.80216344738955,QUEENSTOWN,53676,126635,-72959,90155,0.007829293184732935,751
01611,1.29527259171342,103.85533686181174,DOWNTOWN CORE,42207,31057,11150,36632,0.007630704879905762,12
01621,1.29695888888745,103.85655611109846,DOWNTOWN CORE,44152,23495,20657,33823,0.0070455702979103675,11
01511,1.29919826103807,103.85864518302436,DOWNTOWN CORE,44981,23045,21936,34013,0.007085148642723157,11
01521,1.30088304437602,103.86066098182194,ROCHOR,34351,45490,-11139,39920,0.010298050129215764,67
01411,1.30211332865049,103.86295598167331,KALLANG,32965,87315,-54350,60140,0.00610744513200876,313
01421,1.30338444400173,103.86483888898641,KALLANG,129247,113893,15354,121570,0.012345894657437729,632
01341,1.30647555600578,103.86452527798744,KALLANG,14013,16062,-2049,15037,0.0015270643905888881,78
80011,1.30972720802554,103.86737828692955,KALLANG,84398,81357,3041,82877,0.008416473731384936,431
80031,1.31107705658993,103.8713149052975,KALLANG,303377,246652,56725,275014,0.02792871492408143,1431
80051,1.31251499997324,103.87326194447365,KALLANG,274436,253344,21092,263890,0.026799030526867173,1373
80071,1.31380009198455,103.87655394006379,GEYLANG,195191,329626,-134435,262408,0.01752654900681798,979
80091,1.31489775184137,103.88095141640784,GEYLANG,210952,242534,-31582,226743,0.01514444034272175,845
81081,1.31621665907428,103.88168156879213,GEYLANG,356033,140643,215390,248338,0.01658679661921574,926
81091,1.31935333297674,103.88173111103306,GEYLANG,86355,81236,5119,83795,0.005596769816569284,312
70011,1.32317687661433,103.88116008329277,GEYLANG,29421,32116,-2695,30768,0.0020550320868333877,114
70021,1.32640814876454,103.88033937941422,GEYLANG,55418,46382,9036,50900,0.003399672816556794,189
70031,1.3292670732562,103.87941087761011,GEYLANG,136871,94635,42236,115753,0.007731283448622762,431
70041,1.33340805598283,103.87841250002135,TOA PAYOH,87345,115793,-28448,101569,0.00766525457657636,934
70051,1.33627202154131,103.87777948299751,TOA PAYOH,157859,57757,100102,107808,0.008136102210236827,991
70061,1.3375,103.87444,TOA PAYOH,30779,29809,970,30294,0.0022862410985911475,278
61031,1.33836472248768,103.8704496726279,TOA PAYOH,164578,337988,-173410,251283,0.018963937478618846,2310
61041,1.34142999996834,103.87049194397346,TOA PAYOH,6393,14155,-7762,10274,0.0007753628126667146,94
62111,1.34509852230089,103.87077171254077,SERANGOON,32567,34321,-1754,33444,0.00339633195336614,397
62121,1.34682778451192,103.87156809881778,SERANGOON,33153,32456,697,32804,0.00333133815925795,389
62131,1.3489790064228,103.87277432797597,SERANGOON,291358,212156,79202,251757,0.025566629098899635,2988
62141,1.35149112412235,103.87515194713767,SERANGOON,78822,53858,24964,66340,0.006737012970527143,787
63011,1.35432115760902,103.87823575937183,HOUGANG,91941,121618,-29677,106779,0.005614835503971174,1277
63021,1.3570580828827,103.88161613087621,HOUGANG,29215,41630,-12415,35422,0.0018626200209935187,423
63031,1.36050444441455,103.88535194446017,HOUGANG,477626,291965,185661,384795,0.020233947009717153,4604
63041,1.36259166703136,103.88754805602413,HOUGANG,87751,85588,2163,86669,0.00455737718365669,1037
63051,1.36415166798646,103.8891427848695,HOUGANG,79009,205826,-126817,142417,0.0074888136053817955,1704
63061,1.36623834226067,103.89129134480065,HOUGANG,62902,73146,-10244,68024,0.0035769539920970897,813
64011,1.36756333302324,103.8927594439902,HOUGANG,48895,76387,-27492,62641,0.003293895904665321,749
64541,1.37122666703205,103.89261000001046,HOUGANG,431389,382708,48681,407048,0.02140409221120687,4870
64551,1.36988818748014,103.89033436772391,HOUGANG,19069,8786,10283,13927,0.000732333268374929,166
64529,1.3699286957754,103.88933520735068,HOUGANG,60574,42877,17697,51725,0.0027198921739565738,618
64339,1.37136834322266,103.88702988625133,HOUGANG,59866,85380,-25514,72623,0.0038187864543112278,869
64341,1.3729130421635,103.88633750747994,HOUGANG,153319,218099,-64780,185709,0.009765267389720663,2222
64351,1.37481110511316,103.88808212175417,HOUGANG,116118,140829,-24711,128473,0.0067555864140110755,1537
64431,1.37809447450304,103.88930278976599,HOUGANG,21604,65262,-43658,43433,0.002283868086833366,519
64441,1.37980640697067,103.88818499902484,HOUGANG,42641,87216,-44575,64928,0.003414154839451956,776
64461,1.37938472998807,103.88640309201648,HOUGANG,119336,190303,-70967,154819,0.008140956722663757,1852
66499,1.37912306945844,103.88326933020046,HOUGANG,150004,128978,21026,139491,0.007334953682694566,1669
66541,1.37977511312504,103.88135493816362,HOUGANG,39016,66580,-27564,52798,0.0027763144901026423,631
66551,1.38172660405235,103.88144339399805,HOUGANG,13662,31292,-17630,22477,0.0011819239515518977,268
66561,1.383486,103.882607,HOUGANG,14775,21460,-6685,18117,0.000952658994984461,216
66601,1.38486,103.882346,HOUGANG,16720,19497,-2777,18108,0.0009521857416337484,216
66571,1.384484444,103.8813056,HOUGANG,44402,41178,3224,42790,0.002250056764110233,512
66581,1.382511944,103.8797475,HOUGANG,27386,15727,11659,21556,0.0011334943586623085,257
66549,1.38029830580566,103.88167284722846,HOUGANG,9548,2955,6593,6251,0.0003287007439227171,74
66491,1.37936944398935,103.88260194401967,HOUGANG,95408,124471,-29063,109939,0.005781000013776931,1315
64619,1.37809338718149,103.88468027114665,HOUGANG,103983,123749,-19766,113866,0.005987496225804528,1362
64561,1.37715998902026,103.88690877548076,HOUGANG,51529,10183,41346,30856,0.001622522821065327,369
64359,1.37528677811119,103.88918760776436,HOUGANG,138738,81096,57642,109917,0.005779843172252967,1315
64349,1.37291834719604,103.88673982857989,HOUGANG,110598,76044,34554,93321,0.004907163993538935,1116
64331,1.37143555507852,103.88805955105329,HOUGANG,98594,73101,25493,85847,0.004514153377624939,1027
64521,1.36983992146019,103.88956725593734,HOUGANG,36849,55873,-19024,46361,0.002437833176931865,554
64559,1.37060388901687,103.8908113889665,HOUGANG,13762,44364,-30602,29063,0.0015282402368622505,347
64549,1.37139998302648,103.89170972978319,HOUGANG,240226,380976,-140750,310601,0.01633255155385376,3716
64019,1.368308353364,103.89393838248249,HOUGANG,168098,112192,55906,140145,0.007369343426179681,1676
63069,1.36637999879956,103.89194715850095,HOUGANG,84711,61528,23183,73119,0.003844867972306055,874
63059,1.36437667280221,103.88984149586426,HOUGANG,339383,141587,197796,240485,0.012645592449568808,2877
63049,1.36219166668854,103.88752277779692,HOUGANG,71093,78637,-7544,74865,0.003936679122344299,895
63039,1.36026000003341,103.88538416663954,HOUGANG,425719,766198,-340479,595958,0.031337680042664316,7131
63029,1.35727472200293,103.88218027802674,HOUGANG,41357,55844,-14487,48600,0.0025555680938480325,581
63019,1.35347964311763,103.87800141702434,HOUGANG,113828,70886,42942,92357,0.004856473301307052,1105
62149,1.35169173270668,103.87595332312252,SERANGOON,97699,136995,-39296,117347,0.011916916808146646,1393
62189,1.35056391832311,103.87470953705504,SERANGOON,639,138377,-137738,69508,0.007058732251362687,825
64009,1.37060695394614,103.89266808874676,HOUGANG,1497042,1378880,118162,1437961,0.07561331793822655,17206
64041,1.37016500002901,103.89535999996711,HOUGANG,199140,34819,164321,116979,0.006151189301445452,1399
64051,1.37239666924933,103.89777362456783,HOUGANG,131799,80018,51781,105908,0.005569035096363322,1267
64061,1.37557886299976,103.90111900001394,HOUGANG,123829,120382,3447,122105,0.006420733376529095,1461
64401,1.37839309319848,103.9032366204475,HOUGANG,109732,147140,-37408,128436,0.006753640816902591,1536
67739,1.37998423176832,103.90195091871207,HOUGANG,31331,13213,18118,22272,0.0011711442918967774,266
67729,1.37948933048443,103.89872566951759,HOUGANG,11175,3430,7745,7302,0.0003839662185448217,87
67719,1.37972132476485,103.89527238603087,HOUGANG,23304,10684,12620,16994,0.0008936074935566557,203
67609,1.38393305306468,103.89303978530081,SENGKANG,240464,568134,-327670,404299,0.031245119145592647,3826
67619,1.38776797851536,103.89401435851151,SENGKANG,22063,81635,-59572,51849,0.00400700516840218,490
67341,1.38864779457077,103.89505169031366,SENGKANG,23082,42360,-19278,32721,0.002528751106391401,309
67199,1.3889487081629,103.89689165133598,SENGKANG,72678,62041,10637,67359,0.00520565220425471,637
67189,1.39059955869523,103.89742612835978,SENGKANG,147552,38973,108579,93262,0.0072074932209979774,882
67409,1.3923391568303,103.89606816606354,SENGKANG,860681,416686,443995,638683,0.049358832030909176,6045
67399,1.39385005995777,103.89167010585574,SENGKANG,81933,99636,-17703,90784,0.007015987911207999,859
67389,1.39424377787036,103.88869095686496,SENGKANG,62006,129122,-67116,95564,0.007385396862296013,904
67549,1.39454660425441,103.88618230819876,SENGKANG,43365,55886,-12521,49625,0.003835129539276711,469
67559,1.3954939065925,103.88094503218825,SENGKANG,41873,103052,-61179,72462,0.005600023308313734,685
67569,1.39504999232889,103.87700000087196,SENGKANG,63066,89385,-26319,76225,0.005890836254536369,721
67639,1.393047,103.875914,SENGKANG,15407,43316,-27909,29361,0.002269082889727023,277
67499,1.39068028707514,103.87467870992985,SENGKANG,78536,73871,4665,76203,0.005889136045974876,721
68019,1.39106694073297,103.87060612962611,SENGKANG,66562,70171,-3609,68366,0.005283475387046683,647
67091,1.392881,103.869086,SENGKANG,753,7048,-6295,3900,0.00030140060862829566,36
67991,1.395245,103.871524,SENGKANG,1729,5324,-3595,3526,0.00027249706308291554,33
68031,1.39705024252478,103.87307298530668,SENGKANG,51816,71870,-20054,61843,0.004779363548564023,585
68051,1.39955011852479,103.87232065200857,SENGKANG,9044,13932,-4888,11488,0.0008878179979286822,108
68111,1.40222194447692,103.87138805557646,SELETAR,235934,188123,47811,212028,0.3677868228282194,110
68099,1.40885009957996,103.87095311541565,SELETAR,13961,15688,-1727,14824,0.025713923923281475,7
68209,1.4113435,103.873544,SELETAR,1338,8544,-7206,4941,0.00857072976962586,2
68239,1.41360008537368,103.87287372479017,SELETAR,8910,8895,15,8902,0.015441537423438456,4
68201,1.409829,103.872581,SELETAR,9479,380,9099,4929,0.008549914396779167,2
68091,1.40885699822728,103.8711692911676,SELETAR,11634,13609,-1975,12621,0.02189256839150941,6
68119,1.40231306085319,103.87194871751426,SELETAR,187069,227274,-40205,207171,0.3593618006685204,107
68059,1.39978638898633,103.87243527803194,SENGKANG,7952,7549,403,7750,0.000598937106889562,73
68049,1.39851660309414,103.8729604565282,SENGKANG,15271,22722,-7451,18996,0.0014680528106418218,179
68039,1.39652972197871,103.87311388899468,SENGKANG,58724,32652,26072,45688,0.0035308694889768137,432
67999,1.39506,103.871495,SENGKANG,8161,3381,4780,5771,0.00044599561856253705,54
67099,1.3937,103.869287,SENGKANG,12420,3106,9314,7763,0.0005999417755849896,73
68011,1.3913169267408,103.8701030697383,SENGKANG,94902,112313,-17411,103607,0.008006977655936368,980
67491,1.39087538517899,103.87466488789592,SENGKANG,78982,84439,-5457,81710,0.006314729161799497,773
67631,1.392329,103.87567,SENGKANG,35225,21212,14013,28218,0.00218074932673673,267
67561,1.39545828505824,103.87697696683591,SENGKANG,88441,66543,21898,77492,0.0059887528112368945,733
67551,1.39600529337669,103.87927293767908,SENGKANG,125848,59010,66838,92429,0.007143117142283268,874
67541,1.39478256874239,103.88633251190507,SENGKANG,15983,35734,-19751,25858,0.001998363317412941,244
67381,1.39459040201234,103.88844266691056,SENGKANG,105841,56330,49511,81085,0.006266427782211629,767
67391,1.39425676218487,103.89144488028346,SENGKANG,111842,84357,27485,98099,0.007581307257904405,928
67401,1.39290842289238,103.89531738456282,SENGKANG,243044,507685,-264641,375364,0.029008958476192715,3553
67181,1.39101786005668,103.89778017996501,SENGKANG,54418,185095,-130677,119756,0.009255008022279533,1133
67191,1.38908889970693,103.89710881285436,SENGKANG,102509,91336,11173,96922,0.007490346099864532,917
67349,1.38837810902521,103.8953369095349,SENGKANG,42850,22029,20821,32439,0.002506957523921355,307
67611,1.38776293807936,103.89426271274473,SENGKANG,97461,19656,77805,58558,0.004525491497450189,554
67601,1.38334470717282,103.8932683273077,SENGKANG,536904,273383,263521,405143,0.031310345328588104,3834
67711,1.38013294516415,103.8947798896038,SENGKANG,2884,10102,-7218,6493,0.0005017933722624421,61
67721,1.37971349716278,103.89819238601865,SENGKANG,1898,11665,-9767,6781,0.0005240506479765316,64
67731,1.38018738604916,103.90138066955191,SENGKANG,17743,50267,-32524,34005,0.002627981460616717,321
64409,1.37820165544364,103.90352727356866,HOUGANG,140772,118494,22278,129633,0.006816583512547366,1551
64069,1.37526504951859,103.90134716214978,HOUGANG,108731,105827,2904,107279,0.005641127356788541,1283
64059,1.37249135705281,103.89837470452339,HOUGANG,128272,141699,-13427,134985,0.007098011505104458,1615
64049,1.3703713899857,103.89603248614272,HOUGANG,109114,136240,-27126,122677,0.006450811256152162,1467
63141,1.354019,103.874925,SERANGOON,21443,23723,-2280,22583,0.002293366956789485,268
63361,1.35744648841295,103.87383985365209,SERANGOON,107397,215254,-107857,161325,0.016383005991412288,1915
63181,1.36083138898279,103.87346222201559,SERANGOON,42833,54040,-11207,48436,0.004918811580350508,575
63191,1.36426277802723,103.87403972199432,SERANGOON,41865,75410,-33545,58637,0.005954751726753091,696
63201,1.36617789459924,103.87492029493984,SERANGOON,27725,60347,-32622,44036,0.004471979245856696,522
63211,1.36816,103.875784,HOUGANG,143694,171049,-27355,157371,0.008275150339443595,1883
64101,1.37212119701131,103.87653938842564,HOUGANG,171161,200943,-29782,186052,0.009783303600753378,2226
64111,1.37594188334629,103.87684285462154,HOUGANG,205274,259669,-54395,232471,0.012224186632612056,2781
64121,1.37974139718092,103.87650111729936,HOUGANG,55906,44009,11897,49957,0.0026269241823943653,597
67079,1.38256500000442,103.87673500001087,HOUGANG,34437,52011,-17574,43224,0.0022728780923557067,517
67069,1.385515,103.875233,SERANGOON,3088,10477,-7389,6782,0.0006887311119402334,80
67059,1.38705245959807,103.87298447808229,SERANGOON,47845,146435,-98590,97140,0.00986483931198382,1153
67049,1.38773464426252,103.869986495669,SERANGOON,71897,78837,-6940,75367,0.007653730125862513,894
67081,1.38990180700693,103.86883700264016,SENGKANG,6406,12091,-5685,9248,0.0007147058534857638,87
68021,1.39317909764213,103.8724709608888,SENGKANG,43215,56571,-13356,49893,0.0038558411708439887,472
68061,1.40719212135322,103.87206315994297,SELETAR,1404,6090,-4686,3747,0.006499600171379903,1
68081,1.40559323576727,103.86681241814273,SELETAR,4073,7186,-3113,5629,0.00976414447950293,2
68101,1.40378584520974,103.86344710129676,SELETAR,4828,10011,-5183,7419,0.012869104262467975,3
68121,1.40580853768965,103.85999518683653,SELETAR,9516,13089,-3573,11302,0.019604611992777066,5
68161,1.41076903489058,103.86179481507453,SELETAR,2585,2722,-137,2653,0.004601932013523054,1
68131,1.41460695862945,103.86188939696589,SELETAR,1977,12090,-10113,7033,0.012199543102566015,3
68141,1.42043301652737,103.86347697141191,YISHUN,18274,13568,4706,15921,0.0007984520231438247,176
68151,1.42333311184046,103.86619112165944,SELETAR,7251,5393,1858,6322,0.010966232261399452,3
68171,1.42704251041342,103.85535247743789,YISHUN,10766,5002,5764,7884,0.0003953894699118092,87
59779,1.42408305602704,103.85251851284276,YISHUN,35729,9741,25988,22735,0.0011401800606855633,252
59789,1.42301388896819,103.85136389998303,YISHUN,1146,1576,-430,1361,6.825533593987472e-05,15
59461,1.4233562505923,103.84695938114267,YISHUN,179866,92725,87141,136295,0.006835313013905382,1514
59459,1.42637371131971,103.84259503772017,YISHUN,105494,32899,72595,69196,0.003470239695588223,769
59709,1.42599217250432,103.84064406907125,YISHUN,2883,16846,-13963,9864,0.0004946881952321265,109
59349,1.42345056032348,103.83882425770956,YISHUN,102056,112710,-10654,107383,0.005385351020743253,1193
58991,1.424583611,103.8350086,YISHUN,10164,201209,-191045,105686,0.0053002449920217486,1174
59009,1.4284,103.8360975,YISHUN,3274466,1970264,1304202,2622365,0.13151388981041115,29144
59069,1.42657294826877,103.83536957259517,YISHUN,303615,197625,105990,250620,0.012568811383726232,2785
59341,1.42367163179884,103.83864456915899,YISHUN,50379,90679,-40300,70529,0.0035370908071296284,783
59701,1.42548192920513,103.84020205228329,YISHUN,16515,4770,11745,10642,0.000533705573161019,118
59651,1.42711698762084,103.84169418862261,YISHUN,13281,72675,-59394,42978,0.002155384149907374,477
59451,1.42569613726662,103.84360741617542,YISHUN,28232,73225,-44993,50728,0.0025440534030550807,563
59469,1.42357927683882,103.84747960044407,YISHUN,108572,259608,-151036,184090,0.009232273911220822,2045
59781,1.4232168633454,103.85125812567784,YISHUN,2621,5921,-3300,4271,0.00021419437163791694,47
59771,1.423939,103.852066,YISHUN,18123,37838,-19715,27980,0.0014032213810416566,310
59791,1.425903,103.853576,YISHUN,2384,10465,-8081,6424,0.0003221691977059186,71
68179,1.42698397142724,103.85550329736579,YISHUN,5110,6064,-954,5587,0.00028019291836596624,62
68159,1.42306890210566,103.86626907370781,SELETAR,6119,7576,-1457,6847,0.011876904823442273,3
68149,1.41891604556531,103.86279700000911,SELETAR,23048,17831,5217,20439,0.03545378380112993,10
68139,1.4144389729383,103.86207999648197,SELETAR,1760,1658,102,1709,0.0029644560162498676,0
68169,1.4107138403801,103.86188409763393,SELETAR,1906,2792,-886,2349,0.004074609234740164,1
68129,1.40606522969086,103.86016462232045,SELETAR,15457,7380,8077,11418,0.019805827263628433,5
68109,1.40400332581506,103.86349233396736,SELETAR,9684,4860,4824,7272,0.012614115945095985,3
68089,1.40570196065228,103.86666745163518,SELETAR,4092,4368,-276,4230,0.007337418928459298,2
68069,1.40757217631739,103.87228032413654,SELETAR,5882,2042,3840,3962,0.006872542268216487,2
68029,1.39312162118162,103.87264955115819,SENGKANG,93283,59684,33599,76483,0.005910775064030241,723
67089,1.39029406445756,103.86916019529639,SENGKANG,14583,6464,8119,10523,0.0008132406678450142,99
67041,1.38802587904105,103.87037184486725,SENGKANG,88008,84948,3060,86478,0.006683210726399424,818
67051,1.3873944756683,103.87302341120069,SENGKANG,159082,66411,92671,112746,0.008713259748822007,1067
67061,1.38580333301583,103.8753413890144,SERANGOON,6400,4136,2264,5268,0.0005349801677530447,62
67071,1.38224166699882,103.87700083300696,HOUGANG,55237,32841,22396,44039,0.0023157338124480146,526
64129,1.37995970749936,103.87686804999332,HOUGANG,99443,56415,43028,77929,0.004097795596409122,932
64119,1.37679164872283,103.87713655364794,HOUGANG,304754,201500,103254,253127,0.013310355656203105,3028
64109,1.37202330151763,103.87690900449827,HOUGANG,162331,149558,12773,155944,0.00820011339150283,1866
63219,1.368497,103.876166,SERANGOON,149867,146818,3049,148342,0.015064545946245664,1761
63209,1.36605804817414,103.87522122785421,SERANGOON,77811,25837,51974,51824,0.005262872477910742,615
63199,1.36327972197547,103.87383805598819,HOUGANG,69479,34437,35042,51958,0.0027321441773694665,621
63189,1.36133997852966,103.87363460960414,HOUGANG,23465,22438,1027,22951,0.0012068486280227611,274
63179,1.35999305129204,103.87393532776181,HOUGANG,36030,44754,-8724,40392,0.0021239610379981426,483
63369,1.356702,103.874108,SERANGOON,75758,56761,18997,66259,0.006728787193460324,786
63149,1.35489972198729,103.87452555599006,SERANGOON,50181,48101,2080,49141,0.0049904063066728115,583
66419,1.35021638901553,103.86930944403264,SERANGOON,37905,21548,16357,29726,0.00301875863071887,352
66409,1.34926598081238,103.86593883283692,SERANGOON,11353,21635,-10282,16494,0.0016750119375320272,195
66399,1.35148729748638,103.8632462430678,SERANGOON,12052,16070,-4018,14061,0.0014279339671176086,166
66029,1.35017159420349,103.86143525134639,SERANGOON,26540,40732,-14192,33636,0.0034158300915985975,399
66019,1.34602837489201,103.86040421534554,SERANGOON,10623,8765,1858,9694,0.000984452875132501,115
52069,1.34314389988912,103.85856611406128,TOA PAYOH,68827,77652,-8825,73239,0.005527233505635342,673
52059,1.34309745890513,103.85622585798508,TOA PAYOH,270449,305698,-35249,288073,0.021740421601454004,2649
52361,1.33974408909931,103.8529812160764,TOA PAYOH,224673,341189,-116516,282931,0.021352362852891396,2601
52279,1.33702420555118,103.84992957112877,TOA PAYOH,174166,241301,-67135,207733,0.015677286661835176,1910
52239,1.33412194449168,103.84894805557066,TOA PAYOH,77808,57552,20256,67680,0.005107704415153128,622
52189,1.33318499999452,103.84678305554863,TOA PAYOH,185728,205387,-19659,195557,0.014758382865161056,1798
52079,1.32931477158443,103.84382885735747,NOVENA,315488,290124,25364,302806,0.05230550786121696,2580
51099,1.325881667006,103.8345342161876,NOVENA,88878,87221,1657,88049,0.015209235159383539,750
40249,1.3249247219882,103.82735055603025,NOVENA,6164,42032,-35868,24098,0.004162592975170922,205
40239,1.322585278,103.8262153,NOVENA,161437,270906,-109469,216171,0.037340521455542924,1842
40229,1.319241,103.825711,TANGLIN,62983,93552,-30569,78267,0.03917445689468339,395
40219,1.317033,103.826044,TANGLIN,22537,15620,6917,19078,0.00954898346220974,96
40209,1.31388805600649,103.82738777802837,TANGLIN,49479,62185,-12706,55832,0.02794521672408503,282
40199,1.31258333303153,103.83191222199584,NEWTON,36640,13703,22937,25171,0.030819355794531097,132
09219,1.30731999685228,103.83316088291699,ORCHARD,324655,489714,-165059,407184,0.11493379474253197,105
09111,1.30453752623147,103.82914529614989,RIVER VALLEY,130813,83968,46845,107390,0.10221116470664378,557
09121,1.30397379238249,103.82699645124522,RIVER VALLEY,18260,40247,-21987,29253,0.027842287002173855,151
09131,1.30391999998489,103.82333805603095,TANGLIN,59905,109030,-49125,84467,0.04227770133674757,427
09141,1.30543500002797,103.82177666702269,TANGLIN,35117,36553,-1436,35835,0.017936252351833843,181
13011,1.306504,103.81932,TANGLIN,74072,127167,-53095,100619,0.05036215363162186,508
13021,1.30633972996805,103.81430670816292,TANGLIN,20216,20887,-671,20551,0.010286254278848536,103
11201,1.30692642897557,103.81186453577433,TANGLIN,21599,42618,-21019,32108,0.016070802023515584,162
11211,1.30838779885113,103.80939522851014,TANGLIN,20299,15709,4590,18004,0.009011421441116687,91
11221,1.310019,103.805506,TANGLIN,23360,27998,-4638,25679,0.012852937746413875,129
11089,1.30946135492693,103.80334087354639,BUKIT TIMAH,15919,19104,-3185,17511,0.0029037489553070403,226
11079,1.305441389003,103.80185250000659,QUEENSTOWN,38507,74738,-36231,56622,0.004917200806454975,471
11069,1.30236853162324,103.80161762237655,QUEENSTOWN,15176,22803,-7627,18989,0.001649053832675877,158
11191,1.30801640815091,103.7883731546267,QUEENSTOWN,86284,39056,47228,62670,0.005442424756111286,522
19011,1.30781638901709,103.78423666696615,QUEENSTOWN,195646,166946,28700,181296,0.01574421315755468,1510
19021,1.30965490194051,103.7812018067838,QUEENSTOWN,24210,16060,8150,20135,0.0017485754342476583,167
19031,1.31123416666912,103.77838361113201,QUEENSTOWN,247940,242195,5745,245067,0.021282251598945662,2041
19041,1.31235972197855,103.77552750001337,QUEENSTOWN,19819,37871,-18052,28845,0.0025049743432269036,240
17151,1.31169519353522,103.76960993525367,CLEMENTI,229192,264136,-34944,246664,0.02296374187668244,1001
17161,1.31240993603605,103.76685476875124,CLEMENTI,120310,366870,-246560,243590,0.022677560907716877,989
17171,1.31497399268611,103.76502698264449,CLEMENTI,1398521,2035317,-636796,1716919,0.15984044992042512,6973
17181,1.31749570803723,103.7638854582427,CLEMENTI,57483,37983,19500,47733,0.004443811383094748,193
20101,1.31993714188512,103.76221926730373,CLEMENTI,105195,176240,-71045,140717,0.013100366756645165,571
28011,1.32425805601593,103.7591472219987,CLEMENTI,10258,7687,2571,8972,0.0008352685925696286,36
28021,1.32615808379173,103.75545022241596,CLEMENTI,19206,40024,-20818,29615,0.0027570752751838556,120
28031,1.32790100001681,103.75101499996688,CLEMENTI,102432,57328,45104,79880,0.007436608913783095,324
28041,1.33008349967851,103.74828366332322,JURONG EAST,72501,61468,11033,66984,0.006532697475270028,513
28659,1.33446189256828,103.74767782537164,JURONG EAST,208631,128886,79745,168758,0.016458332744112316,1293
28649,1.33901303401774,103.74603439301079,JURONG EAST,183073,195346,-12273,189209,0.01845284182190324,1450
28639,1.34045649755771,103.74395996871245,JURONG EAST,183127,150424,32703,166775,0.016264938215665815,1278
28319,1.33862623918679,103.74173313734524,JURONG EAST,79639,89361,-9722,84500,0.008240967046762172,647
28449,1.33618166701348,103.73944500002973,JURONG EAST,29807,135064,-105257,82435,0.008039575366862008,631
28211,1.33418677275445,103.74070680700304,JURONG EAST,95426,1512320,-1416894,803873,0.07839870890866092,6162
28009,1.33235,103.740664,JURONG EAST,1257032,491274,765758,874153,0.0852528528618733,6700
28441,1.33576638902918,103.73884916698127,JURONG EAST,186428,22429,163999,104428,0.010184469902476689,800
28311,1.33825277511898,103.74108351905207,JURONG EAST,78785,65352,13433,72068,0.007028520865397116,552
28631,1.34053157728505,103.74418616293988,JURONG EAST,178114,174027,4087,176070,0.017171444590809656,1349
28641,1.33917889755759,103.74610320575732,JURONG EAST,129585,126433,3152,128009,0.012484236102828153,981
28651,1.33515192012369,103.74794188238828,JURONG EAST,86159,159152,-72993,122655,0.011962080628646322,940
28049,1.33069921313648,103.7481034124348,JURONG EAST,53221,64875,-11654,59048,0.005758729256535063,452
28039,1.3280750000324,103.75140833297368,CLEMENTI,51877,96902,-45025,74389,0.006925411873903489,302
28029,1.32688998200812,103.75436027668461,CLEMENTI,54604,40742,13862,47673,0.004438225547656253,193
28019,1.32492720506757,103.75894333173954,CLEMENTI,11625,13290,-1665,12457,0.0011597125342888836,50
20109,1.32085220079341,103.76206999856427,CLEMENTI,215873,110404,105469,163138,0.015187700362753463,662
17189,1.31790502165515,103.76406408827933,CLEMENTI,100109,107761,-7652,103935,0.009676063438333075,422
17179,1.31528191560846,103.76536000516927,CLEMENTI,1018179,1131321,-113142,1074750,0.10005627729204283,4365
17169,1.31284527799656,103.76679666702314,CLEMENTI,101528,63967,37561,82747,0.007703518750485851,336
17159,1.311975556,103.7698144,CLEMENTI,284545,230184,54361,257364,0.023959882529880728,1045
19049,1.31266302174215,103.77479215922537,QUEENSTOWN,75202,34946,40256,55074,0.004782768486007228,458
19039,1.31167951129602,103.77868390552867,QUEENSTOWN,318322,272371,45951,295346,0.025648609893385098,2460
19029,1.3095609201372,103.78201879388226,QUEENSTOWN,8642,21174,-12532,14908,0.0012946492462758425,124
19019,1.30807305598128,103.78475916699466,QUEENSTOWN,185606,193180,-7574,189393,0.01644737756237729,1577
11199,1.30837970735444,103.78843145303215,QUEENSTOWN,64820,83647,-18827,74233,0.006446585558008762,618
11061,1.30265777802206,103.80118694402536,QUEENSTOWN,57232,51415,5817,54323,0.004717549705221532,452
11071,1.30621305601609,103.80170944396954,QUEENSTOWN,84432,104198,-19766,94315,0.008190558335290187,785
11081,1.30851972202313,103.80258027799627,TANGLIN,15069,16465,-1396,15767,0.007891750825488047,79
11229,1.31060065879064,103.80522542227166,TANGLIN,32751,24614,8137,28682,0.014356009207626573,144
11219,1.30988506093033,103.80716407830104,TANGLIN,14252,14286,-34,14269,0.007141966926421574,72
11209,1.30817280849852,103.81038349817638,TANGLIN,45757,30733,15024,38245,0.019142513497862015,193
13029,1.30671783282361,103.8145185880206,TANGLIN,20692,19865,827,20278,0.010149611418738292,102
13019,1.3067380217198,103.82013079894885,TANGLIN,208748,98509,110239,153628,0.07689439308797348,776
09149,1.30608981381948,103.8212215023314,TANGLIN,31843,24261,7582,28052,0.014040679530449084,141
09159,1.30602637557418,103.82568042620605,ORCHARD,137576,92168,45408,114872,0.032424345921411774,29
09169,1.3070135326348,103.82835507326037,ORCHARD,217082,153416,63666,185249,0.052289310341907605,48
09179,1.30587966240898,103.83049004618626,ORCHARD,164747,223588,-58841,194167,0.05480654967722996,50
09213,1.30783805600034,103.83305083303023,ORCHARD,170018,75080,94938,122549,0.03459129438264409,31
40191,1.31268555601325,103.8304269440197,NEWTON,20876,44719,-23843,32797,0.04015662516361036,173
40201,1.31358972201496,103.82743055599407,TANGLIN,48814,46019,2795,47416,0.02373281265563146,239
40211,1.31655331624558,103.825862990405,TANGLIN,12124,22415,-10291,17269,0.00864353681774295,87
40221,1.31902531287493,103.82545561296305,TANGLIN,6563,26627,-20064,16595,0.008306184115492748,83
40231,1.32230868317131,103.82577145824762,NOVENA,304239,144941,159298,224590,0.038794786135514875,1913
51091,1.32648060854916,103.83401870730577,NOVENA,86536,62002,24534,74269,0.012828932594944362,632
51101,1.32753637537789,103.83724817699014,NOVENA,8510,10197,-1687,9353,0.00161560013680694,79
52071,1.32991416932901,103.84381843224321,TOA PAYOH,344590,341273,3317,342931,0.025880469603913672,3153
52181,1.33306633976898,103.84656071660625,TOA PAYOH,72256,154566,-82310,113411,0.008558951912336457,1042
52231,1.3343049899737,103.8487842386021,TOA PAYOH,40930,48702,-7772,44816,0.0033821938692302394,412
52271,1.33683113907107,103.84974718092391,TOA PAYOH,208697,127871,80826,168284,0.01270013194148388,1547
52369,1.34001833298065,103.85273333299853,TOA PAYOH,262960,136444,126516,199702,0.015071199573210846,1836
52051,1.34338820709349,103.85469257245785,BISHAN,173571,126398,47173,149984,0.01968043954521263,1718
52061,1.34352174018964,103.85873879159365,BISHAN,79253,45872,33381,62562,0.008209193372810383,716
66011,1.34716997902419,103.8599767808637,SERANGOON,17254,15205,2049,16229,0.0016481004446591045,192
66021,1.35096671417894,103.86182938341672,SERANGOON,45935,23584,22351,34759,0.0035298738896978135,412
66391,1.35096942673026,103.86484232962732,SERANGOON,21860,21222,638,21541,0.0021875489357570874,255
66401,1.34937635159369,103.86604085565898,SERANGOON,14679,9731,4948,12205,0.0012394519642038556,144
66411,1.35002972706339,103.86903123228186,SERANGOON,29667,33060,-3393,31363,0.0031850005697112264,372
66389,1.35092163758707,103.8710690514159,SERANGOON,125926,425750,-299824,275838,0.028012122155023605,3274
43009,1.34999354306126,103.75106190953444,BUKIT BATOK,1832856,1615562,217294,1724209,0.13873373978571937,10749
43179,1.3489707828044,103.75430345301592,BUKIT BATOK,138352,131468,6884,134910,0.010855162474207826,841
43189,1.34694984968785,103.75681389918313,BUKIT BATOK,314384,281155,33229,297769,0.023959164441348973,1856
43619,1.34406411828167,103.75861329619691,BUKIT BATOK,107037,92226,14811,99631,0.008016534671023643,621
43629,1.34240810773422,103.75915813592935,BUKIT BATOK,22286,28185,-5899,25235,0.002030464939860903,157
42319,1.33915373900693,103.76043841269879,BUKIT BATOK,116211,133359,-17148,124785,0.010040482168438392,777
28109,1.33327344230787,103.7593317971408,CLEMENTI,23556,35328,-11772,29442,0.002740969449669528,119
28189,1.32992124735954,103.75850603827898,CLEMENTI,15645,21037,-5392,18341,0.0017074967962906328,74
11401,1.30906722197973,103.79507444402137,QUEENSTOWN,110447,142022,-31575,126234,0.010962486782558675,1051
11239,1.31152857401616,103.80165517330278,BUKIT TIMAH,38086,25814,12272,31950,0.005298085724519441,412
09048,1.30386684425114,103.83413070051408,ORCHARD,360986,507077,-146091,434031,0.12251176339418025,112
09038,1.30154262450563,103.83852481842337,ORCHARD,228123,230452,-2329,229287,0.06471969673447613,59
08138,1.3004785730821,103.84184700607595,ORCHARD,213018,155906,57112,184462,0.052067167781143,47
08057,1.29930997279734,103.84529021429745,MUSEUM,386491,749997,-363506,568244,0.2994292736108996,152
08069,1.29821382250893,103.84936128375956,MUSEUM,150543,290197,-139654,220370,0.11612129477061604,59
04179,1.29647916306741,103.85147164487202,MUSEUM,70396,104030,-33634,87213,0.04595583101524589,23
02049,1.29452091230981,103.85402155505173,DOWNTOWN CORE,122099,124722,-2623,123410,0.025707176491296408,40
02151,1.29317776320814,103.85784623004031,DOWNTOWN CORE,128919,155058,-26139,141988,0.02957710538567535,47
02161,1.29268553508737,103.86093156188176,DOWNTOWN CORE,58634,23309,35325,40971,0.00853454929118309,13
02171,1.29070000003898,103.86092194446034,DOWNTOWN CORE,24757,23610,1147,24183,0.0050374900663562195,8
03509,1.28314999997332,103.86004388891767,DOWNTOWN CORE,58059,129452,-71393,93755,0.01952983009433186,31
03519,1.28124500000125,103.85884799997385,DOWNTOWN CORE,15901,11022,4879,13461,0.002804021576447135,4
03539,1.2775330547661,103.85561610012866,DOWNTOWN CORE,6052,9929,-3877,7990,0.0016643735529167677,2
03529,1.27939957419063,103.85278769921703,DOWNTOWN CORE,41385,35160,6225,38272,0.007972328487763521,12
03218,1.2740788888387,103.84687388890413,DOWNTOWN CORE,27044,90678,-63634,58861,0.01226116291592414,19
03239,1.27464226961973,103.84756721372408,DOWNTOWN CORE,16298,779,15519,8538,0.0017785258316399704,2
03381,1.28162601329006,103.85306513725685,DOWNTOWN CORE,29678,18520,11158,24099,0.005019992271807407,7
03391,1.28037660340352,103.85498006767988,DOWNTOWN CORE,18058,21730,-3672,19894,0.004144061008976994,6
03511,1.28194779470571,103.85897064872482,DOWNTOWN CORE,59533,46716,12817,53124,0.011066105209655867,17
03501,1.28500467671367,103.8606110538643,DOWNTOWN CORE,47252,11266,35986,29259,0.006094856794091578,9
02051,1.2895030556082,103.85903388899317,DOWNTOWN CORE,45486,19255,26231,32370,0.006742900113631511,10
02061,1.2899638888957,103.85640388886262,DOWNTOWN CORE,109756,36225,73531,72990,0.015204333620449923,24
04111,1.29395444170081,103.85139096636622,DOWNTOWN CORE,126203,138892,-12689,132547,0.027610478262635647,43
04121,1.29618544092334,103.84958029974611,MUSEUM,133931,100123,33808,117027,0.06166595617879423,31
08041,1.29811014243867,103.84780636909545,MUSEUM,233619,134671,98948,184145,0.09703297102842988,49
08031,1.29831153783592,103.8452569595532,MUSEUM,404834,183439,221395,294136,0.15499139247016347,79
08111,1.29986928715834,103.84093746088925,ORCHARD,121826,161620,-39794,141723,0.040003443633089365,36
08121,1.30027569326586,103.83877618459663,ORCHARD,422614,295917,126697,359265,0.10140793785653598,93
09059,1.30044251755834,103.83623804216019,ORCHARD,89040,62701,26339,75870,0.021415446105730828,19
09022,1.30252834773643,103.83239784275958,RIVER VALLEY,508693,144378,364315,326535,0.3107879939238656,1693
11231,1.31115316310297,103.80119919777994,BUKIT TIMAH,25195,34283,-9088,29739,0.004931448242925936,383
11419,1.31102981378085,103.79604399202725,BUKIT TIMAH,112493,125137,-12644,118815,0.019702411748318542,1534
11409,1.3076441670056,103.79432583301961,QUEENSTOWN,44844,54530,-9686,49687,0.004314947484552441,413
28181,1.32996642498284,103.75819801692671,CLEMENTI,22954,23204,-250,23079,0.0021485916014171266,93
28101,1.33312436803086,103.75905617435505,CLEMENTI,32686,23481,9205,28083,0.0026144502769876146,114
42311,1.33865749997067,103.76028055601957,BUKIT BATOK,153301,135844,17457,144572,0.011632588757106023,901
43621,1.34169275195642,103.75908187494267,BUKIT BATOK,24587,26112,-1525,25349,0.002039637636636974,158
43611,1.3440783607984,103.75829172450743,BUKIT BATOK,54094,86463,-32369,70278,0.005654726175690294,438
43181,1.34648944401178,103.75681722199707,BUKIT BATOK,213944,234196,-20252,224070,0.018029176900124136,1396
43171,1.34859644473183,103.75460496382075,BUKIT BATOK,132728,132548,180,132638,0.010672352236705785,826
63351,1.36922638899711,103.88786388897049,HOUGANG,47271,32037,15234,39654,0.0020851542632397096,474
63341,1.36751402871615,103.88882988119938,HOUGANG,207151,208400,-1249,207775,0.010925579438256686,2486
62139,1.3490461240579,103.87341165935781,SERANGOON,199375,435303,-235928,317339,0.03222666504452989,3767
61111,1.3354995,103.872035,TOA PAYOH,43346,31851,11495,37598,0.002837462627082259,345
61019,1.33320166700854,103.86976166703383,TOA PAYOH,52983,43729,9254,48356,0.0036493521675405537,444
60269,1.33099030126892,103.86922890950602,TOA PAYOH,448585,264064,184521,356324,0.026891218499187696,3276
60209,1.32986133945973,103.86896099565628,TOA PAYOH,23599,32303,-8704,27951,0.0021094185299637275,257
60179,1.32634025655419,103.86834025123765,KALLANG,248470,261088,-12618,254779,0.02587377391566445,1326
60221,1.32212380559601,103.87081431318353,KALLANG,141487,260003,-118516,200745,0.020386416245844672,1045
60039,1.31996473842763,103.86983042567824,KALLANG,64791,19918,44873,42354,0.004301209363503476,220
60029,1.31717045698013,103.86600136758759,KALLANG,49525,69153,-19628,59339,0.006026100543536213,308
60019,1.31479811892165,103.86413644350252,KALLANG,35370,33308,2062,34339,0.0034872557098112543,178
07369,1.31140805601851,103.86237888899062,KALLANG,94540,128594,-34054,111567,0.011330052062567698,580
07379,1.31017336740849,103.86338225534827,KALLANG,71503,148057,-76554,109780,0.011148575433853038,571
01319,1.30757426746418,103.86325596123476,KALLANG,127215,265331,-138116,196273,0.019932267681987952,1021
01219,1.30526598535719,103.86072019914616,KALLANG,69536,75395,-5859,72465,0.007359095635035165,377
01239,1.30291236608351,103.86161817611134,KALLANG,39209,57227,-18018,48218,0.004896720807702002,251
01231,1.3032499999752,103.8610830559663,ROCHOR,23221,6906,16315,15063,0.0038857597469032328,25
01211,1.30551803523268,103.8605449516032,KALLANG,176484,157184,19300,166834,0.01694262555958679,868
01311,1.3070916463394,103.86219695240973,KALLANG,451408,248583,202825,349995,0.03554331990318268,1821
07371,1.30950750000455,103.86350138902452,KALLANG,175830,104228,71602,140029,0.014220476128866889,728
60011,1.31471795031338,103.86376795493321,KALLANG,42127,41562,565,41844,0.004249416928895486,217
60021,1.31828596087227,103.86669874193286,KALLANG,40513,43011,-2498,41762,0.004241089517840869,217
60031,1.3204097072077,103.87007832529532,KALLANG,87787,179537,-91750,133662,0.013573883126613817,695
60229,1.32258108743147,103.87024013608315,KALLANG,214933,85200,129733,150066,0.015239771552710786,781
60159,1.32409476572475,103.86764196002876,KALLANG,270059,244045,26014,257052,0.026104605687946723,1338
60161,1.32477289725503,103.8655673081052,KALLANG,309418,299715,9703,304566,0.03092983262513103,1585
60201,1.32933888886,103.8683861111429,TOA PAYOH,24777,30850,-6073,27813,0.0020990038844363765,255
60261,1.33132471594343,103.86891794930561,TOA PAYOH,314523,414237,-99714,364380,0.027499192298958287,3350
61119,1.335623,103.871938,TOA PAYOH,15272,37868,-22596,26570,0.002005196606244365,244
63349,1.36687207146588,103.88923358520269,HOUGANG,195473,224939,-29466,210206,0.011053410426654722,2515
63359,1.36936804895468,103.88779233654836,HOUGANG,29546,50270,-20724,39908,0.0020985105244709316,477
02089,1.29152694444975,103.8592061110504,DOWNTOWN CORE,13511,88569,-75058,51040,0.010631993259182957,16
02169,1.29333836780589,103.86070849052753,DOWNTOWN CORE,1556,15636,-14080,8596,0.0017906076421617691,2
02141,1.29576571603037,103.85933814632858,DOWNTOWN CORE,4830,654,4176,2742,0.000571178007771937,0
66361,1.35258501828366,103.86824850324253,SERANGOON,42737,65893,-23156,54315,0.005515840510916216,644
66041,1.3557230306281,103.8697219448858,SERANGOON,95672,88388,7284,92030,0.009345904487151235,1092
66051,1.35585499445871,103.87196190877665,SERANGOON,214772,64829,149943,139800,0.014197081900507906,1659
64491,1.37513027801163,103.87905166700338,HOUGANG,201866,246950,-45084,224408,0.011800204214079202,2685
64481,1.37514474329335,103.8807864140804,HOUGANG,143350,98059,45291,120704,0.006347063604934833,1444
64471,1.37454805598778,103.8839677779891,HOUGANG,193206,120407,72799,156806,0.00824544054575997,1876
64601,1.37548640364406,103.8845866729986,HOUGANG,98321,69071,29250,83696,0.004401045826804628,1001
64611,1.37837333826782,103.88445923003084,HOUGANG,115404,87557,27847,101480,0.0053361944478127225,1214
64469,1.3795683329839,103.88576472203239,HOUGANG,136341,69531,66810,102936,0.0054127563232168946,1231
64629,1.38153999996628,103.88805638900106,HOUGANG,60147,20557,39590,40352,0.0021218576897727532,482
67459,1.38288638899819,103.88911083301012,SENGKANG,11421,9686,1735,10553,0.0008155591340652319,99
67469,1.38533638989648,103.8907421565758,SENGKANG,24069,54242,-30173,39155,0.003025984828420748,370
67279,1.38809305404187,103.89167879073923,SENGKANG,70312,66119,4193,68215,0.005271805773738254,645
67449,1.39203289077574,103.89307115004729,SENGKANG,205079,185222,19857,195150,0.015081622762515873,1847
67419,1.39451056390105,103.89388277014375,SENGKANG,113508,111226,2282,112367,0.008683969792239923,1063
67599,1.3972004371065,103.89490664468322,SENGKANG,88997,94534,-5537,91765,0.0070918017566091165,868
65199,1.39591721161169,103.90542736761212,PUNGGOL,1029379,947973,81406,988676,0.13436827641150934,23440
77339,1.3780301775267,103.93278653475954,PASIR RIS,110660,197710,-87050,154185,0.014538640384181815,1054
77289,1.37889759950996,103.93596534133927,PASIR RIS,298344,268005,30339,283174,0.026701462218440844,1936
77239,1.37741830757924,103.93793201117523,PASIR RIS,98452,72139,26313,85295,0.008042762470855063,583
77249,1.37599439507295,103.939861116152,PASIR RIS,81697,67808,13889,74752,0.007048626299564543,511
78049,1.3744627816256,103.94180578126523,PASIR RIS,100303,50918,49385,75610,0.007129530106352674,517
77019,1.3737108000359,103.94351079998545,PASIR RIS,104492,62031,42461,83261,0.007850969530287397,569
77029,1.37274960000662,103.94597779999948,PASIR RIS,127514,100625,26889,114069,0.010755963096171713,780
77039,1.37159118708865,103.94834855629753,PASIR RIS,135488,292812,-157324,214150,0.020192948978646014,1464
77049,1.36963556960047,103.95158314847573,PASIR RIS,48924,34347,14577,41635,0.003925909085808671,284
77059,1.36936138996292,103.95506338293471,PASIR RIS,87835,132303,-44468,110069,0.01037878917175152,752
78069,1.36869168470813,103.95815838787027,PASIR RIS,278833,300313,-21480,289573,0.027304846204032045,1980
78059,1.36677606799955,103.96113744871693,PASIR RIS,166714,114521,52193,140617,0.013259266432548525,961
98111,1.36733773244319,103.96424470880473,PASIR RIS,8813,36921,-28108,22867,0.002156209032429131,156
98109,1.366943,103.965843,PASIR RIS,65921,55396,10525,60658,0.005719653976869998,414
98031,1.36722636029551,103.96801787240187,PASIR RIS,41124,43611,-2487,42367,0.003994931913977566,289
98041,1.36905889178012,103.96968330432956,PASIR RIS,8310,59101,-50791,33705,0.0031781617806456407,230
98231,1.37118600522884,103.97184133530571,PASIR RIS,7980,82482,-74502,45231,0.004264988443862423,309
98051,1.37300166698251,103.97371333299213,PASIR RIS,1861,47093,-45232,24477,0.002308021537008258,167
98061,1.37652810391204,103.977166226331,PASIR RIS,7908,36998,-29090,22453,0.0021171715312516414,153
98071,1.37965443818622,103.97838930249063,PASIR RIS,3900,34176,-30276,19038,0.0017951592932779026,130
99011,1.38328110134472,103.97812168830427,CHANGI,567,1850,-1283,1208,0.0003855176835493413,0
99021,1.38667053181061,103.97916912424074,CHANGI,5307,37139,-31832,21223,0.006773047845999728,12
99031,1.38790615442763,103.98177807887794,CHANGI,5249,21876,-16627,13562,0.00432813809958292,8
99041,1.38779999993686,103.98547333334741,CHANGI,20317,49477,-29160,34897,0.011136929306971327,20
99139,1.38819494717642,103.98723382929484,CHANGI,221,70640,-70419,35430,0.011307029410722817,20
99009,1.38969812175274,103.98762553601895,CHANGI,109076,122897,-13821,115986,0.03701544208953138,68
99131,1.38894186746545,103.98734296938127,CHANGI,93443,493,92950,46968,0.014989233908067437,27
99049,1.38749994542049,103.98573364026825,CHANGI,56273,25984,30289,41128,0.013125472921371945,24
99039,1.38768581439487,103.98202131073424,CHANGI,19449,4247,15202,11848,0.003781137015474003,6
99029,1.38664086819653,103.97959306203218,CHANGI,36503,5066,31437,20784,0.00663294663484231,12
99019,1.3837089764569,103.97844860768319,CHANGI,971,543,428,757,0.00024158682652885048,0
98079,1.37859016739254,103.97870069719525,CHANGI,31386,3411,27975,17398,0.005552348227145232,10
98069,1.3757102208247,103.976778734029,CHANGI,28262,2772,25490,15517,0.004952051238108551,9
98059,1.37320003118402,103.97437194693713,PASIR RIS,54910,2266,52644,28588,0.0026956620378311104,195
98239,1.37149806503652,103.97258859531347,PASIR RIS,45179,1997,43182,23588,0.0022241946323058705,161
98049,1.36955111611083,103.97064054814314,PASIR RIS,118616,55663,62953,87139,0.008216639650012772,596
98039,1.3673740332815,103.96847160564306,PASIR RIS,3309,1994,1315,2651,0.00024997201840948205,18
98101,1.36705781222851,103.96535083584567,PASIR RIS,103492,137960,-34468,120726,0.011383674799888017,825
98119,1.3671897219745,103.96432861100051,PASIR RIS,86903,32688,54215,59795,0.005638278702676342,409
78051,1.36625310810093,103.96118122599651,PASIR RIS,135428,147002,-11574,141215,0.013315653934249345,965
78061,1.36824361151738,103.95848117561664,PASIR RIS,233531,196469,37062,215000,0.020273098437585305,1470
77051,1.36908504460753,103.95508527984948,PASIR RIS,167581,88350,79231,127965,0.012066265309607459,875
77041,1.36944854648197,103.95130450100082,PASIR RIS,40268,52089,-11821,46178,0.004354284370468904,315
77031,1.37116337071002,103.9483810573245,PASIR RIS,217071,197610,19461,207340,0.019550810372320638,1418
77021,1.3726630000055,103.94557280001845,PASIR RIS,103121,116206,-13085,109663,0.010340506018422872,750
77011,1.37376489998905,103.94266590001561,PASIR RIS,78586,144578,-65992,111582,0.010521455208663459,763
77241,1.37531331487507,103.940272636011,PASIR RIS,53986,53513,473,53749,0.005068180315915221,367
77231,1.37670503142246,103.93844026085439,PASIR RIS,62859,56569,6290,59714,0.005630640930706832,408
77281,1.37837166677052,103.93618729229594,PASIR RIS,175253,209507,-34254,192380,0.01814017989498912,1315
77331,1.3782973982979,103.93338764757789,PASIR RIS,231951,142802,89149,187376,0.017668335315539463,1281
65191,1.39527356921611,103.90539999997036,SENGKANG,1024255,1078841,-54586,1051548,0.0812659505645813,9953
67591,1.39790048032037,103.8953647897483,SENGKANG,111686,85079,26607,98382,0.0076031781225817914,931
67411,1.39495624396821,103.89436833778728,SENGKANG,65540,104036,-38496,84788,0.00655260379599383,802
67441,1.3923095386042,103.8934666647416,SENGKANG,209854,306701,-96847,258277,0.019960216665305213,2444
67271,1.38825138740075,103.89208955744495,SENGKANG,58674,49170,9504,53922,0.00416721118421922,510
67461,1.38575273465234,103.89121528705635,SENGKANG,59285,28189,31096,43737,0.0033800919024553253,413
67451,1.383046111,103.88960583301704,SENGKANG,21199,24940,-3741,23069,0.0017828232411400394,218
64621,1.38133333296872,103.88821499999295,HOUGANG,35112,67458,-32346,51285,0.002696755343477291,613
64609,1.37595638900393,103.884701388976,HOUGANG,71617,87224,-15607,79420,0.004176197901510509,950
64479,1.374401340713,103.88353995121632,HOUGANG,127523,184889,-57366,156206,0.00821389032237913,1869
64489,1.37488764981722,103.88067688397112,HOUGANG,136554,177639,-41085,157096,0.008260689820394043,1879
64499,1.3748828566071,103.87828864496953,HOUGANG,101498,64423,37075,82960,0.004362344219457464,992
66059,1.35553141738293,103.87212299732872,SERANGOON,86163,120967,-34804,103565,0.010517316073148078,1229
66049,1.35535475300084,103.86896493522666,SERANGOON,41794,47356,-5562,44575,0.004526716206832189,529
66369,1.35355301663986,103.86822572103661,SERANGOON,120635,59003,61632,89819,0.009121371239068095,1066
80009,1.3111642220841,103.87216341433337,KALLANG,26991,26959,32,26975,0.0027394135755892304,140
80119,1.30992065473549,103.87599804972949,GEYLANG,53125,104813,-51688,78969,0.00527443541553386,294
80189,1.3050374120041,103.88107698307338,KALLANG,1012,596,416,804,8.164924985259467e-05,4
80179,1.30059405278951,103.87712870384925,KALLANG,378,451,-73,414,4.204327044648531e-05,2
80199,1.30155838525089,103.87513532479657,KALLANG,75774,75776,-2,75775,0.0076952386910203495,394
80191,1.30160887226464,103.87540590231113,KALLANG,4348,1664,2684,3006,0.000305270702807089,15
90039,1.29663305723862,103.87539308856654,KALLANG,890,15452,-14562,8171,0.0008297960454546655,42
90029,1.29700669642984,103.87253085603427,KALLANG,15266,66775,-51509,41020,0.004165736603175912,213
90019,1.29697091533768,103.86961360282373,KALLANG,596,1803,-1207,1199,0.00012176299822544901,6
90079,1.29760718196372,103.86732745550238,KALLANG,51982,50972,1010,51477,0.005227684620226387,267
90011,1.29711286404721,103.86924820515104,KALLANG,5826,296,5530,3061,0.00031085616144128393,15
90021,1.297235556,103.8710544,KALLANG,51325,2392,48933,26858,0.0027275317817673974,139
90031,1.29656022698907,103.87500520610656,KALLANG,15900,1254,14646,8577,0.0008710268855543588,44
80171,1.30084075195035,103.87715353250198,KALLANG,324,241,83,282,2.8638169724417533e-05,1
80181,1.30508439498564,103.87969842035083,KALLANG,605,1528,-923,1066,0.00010825634371003224,5
80111,1.30987138105238,103.87551499911487,GEYLANG,23346,27805,-4459,25575,0.00170818531008723,95
67759,1.39129522332876,103.89720218513328,SENGKANG,58377,57863,514,58120,0.004491641890635011,550
67359,1.39008740102191,103.89042014225743,SENGKANG,45617,23977,21640,34797,0.002689188968830463,329
67369,1.39071731059511,103.88853458899818,SENGKANG,100078,31311,68767,65694,0.00507697732903263,621
67379,1.3927256179225,103.88700896307408,SENGKANG,236288,93195,143093,164741,0.012731548119495914,1559
67761,1.396006,103.887595,SENGKANG,30665,23306,7359,26985,0.0020854603650857844,255
67319,1.39738047818719,103.8888966274991,SENGKANG,33060,10235,22825,21647,0.0016729279423017222,204
67429,1.39637340662334,103.89381749259768,SENGKANG,9664,2384,7280,6024,0.00046554801701970594,57
95151,1.34209640049942,103.98181795541137,CHANGI,13705,107036,-93331,60370,0.019266310062809384,35
95011,1.34719486317101,103.98406055558529,CHANGI,11541,34682,-23141,23111,0.0073755787951232015,13
95109,1.35650049529119,103.98635233782801,CHANGI,408267,476175,-67908,442221,0.14112915193449774,261
95029,1.36126748727797,103.99069984684058,CHANGI,560491,544381,16110,552436,0.1763028535010463,326
95129,1.35509298857124,103.9892195407387,CHANGI,132393,89916,42477,111154,0.03547337135533401,65
95019,1.34794299896363,103.98488339642644,CHANGI,48455,21743,26712,35099,0.011201395012333056,20
95209,1.33899412275069,103.98206408704047,CHANGI,19965,12705,7260,16335,0.005213105431108022,9
95159,1.34191465289349,103.98225051798305,CHANGI,99308,14265,85043,56786,0.018122522498371603,33
67421,1.39616692483827,103.89376724340975,SENGKANG,3517,20147,-16630,11832,0.0009144030772538448,111
67311,1.39695849054084,103.88980246889258,SENGKANG,6906,37893,-30987,22399,0.0017310441622218448,212
67769,1.39607378603056,103.88766378607079,SENGKANG,19555,35775,-16220,27665,0.002138012266077385,261
67371,1.39259972198676,103.88713972197542,SENGKANG,72795,176340,-103545,124567,0.009626812721795105,1179
67361,1.39099505909557,103.88834913656447,SENGKANG,32877,94583,-61706,63730,0.004925195073815714,603
67351,1.38995158321899,103.89134430221003,SENGKANG,21045,37639,-16594,29342,0.0022676145277875518,277
11159,1.29800440816386,103.80362656855579,QUEENSTOWN,146294,128546,17748,137420,0.011933907930186899,1144
11149,1.29506407111991,103.80596280094791,QUEENSTOWN,255185,132168,123017,193676,0.016819324350799577,1613
11139,1.2931986108138,103.80744694841283,QUEENSTOWN,54763,39627,15136,47195,0.004098535764555164,393
10299,1.29233498466278,103.81146486767658,QUEENSTOWN,318002,263802,54200,290902,0.025262681448895572,2423
10289,1.2918699745378,103.81440639448375,QUEENSTOWN,32850,30022,2828,31436,0.002729983479066769,261
10321,1.29428332949691,103.81587839882768,QUEENSTOWN,67256,56591,10665,61923,0.0053775533456626645,515
13031,1.29912972200223,103.81707388901162,TANGLIN,26247,21936,4311,24091,0.01205810675060776,121
13041,1.30242834318416,103.81967634723284,TANGLIN,8216,4807,3409,6511,0.003258907187464494,32
13201,1.30453622259471,103.82209559895128,TANGLIN,12009,25033,-13024,18521,0.009270191985721071,93
13209,1.3040310710651,103.82205605505206,TANGLIN,15783,4389,11394,10086,0.005048277974622468,50
13049,1.30261671321463,103.82045069624506,TANGLIN,3893,5175,-1282,4534,0.002269372629083707,22
13039,1.29981572699945,103.81744265557978,TANGLIN,20923,28558,-7635,24740,0.012382946370430284,125
10329,1.29364671283262,103.81597460107542,BUKIT MERAH,75997,60739,15258,68368,0.003984199567092428,602
10281,1.29153833298318,103.81445166697797,BUKIT MERAH,66812,85240,-18428,76026,0.004430475606830226,670
10291,1.29215855273858,103.81065866068086,BUKIT MERAH,189006,234859,-45853,211932,0.012350505830988656,1868
11131,1.2928849988829,103.80706694417339,QUEENSTOWN,21657,54522,-32865,38089,0.0033077471922055655,317
11141,1.29463705145492,103.80582510668431,QUEENSTOWN,185996,295905,-109909,240950,0.020924720679511958,2007
11151,1.29863585845076,103.80247592925552,QUEENSTOWN,85127,97983,-12856,91555,0.007950872802708933,762
64329,1.37240520198465,103.90067635112096,HOUGANG,20438,60799,-40361,40618,0.002135844955471592,486
64319,1.36984558380582,103.90037616571983,HOUGANG,2612,7231,-4619,4921,0.00025876441542852196,58
64309,1.3670813438207,103.89926444088415,HOUGANG,11856,8348,3508,10102,0.0005312005943220745,120
64239,1.36439805444874,103.89682349089492,HOUGANG,28985,34853,-5868,31919,0.0016784193001550484,381
64209,1.36146974234447,103.89452504836862,HOUGANG,103979,121784,-17805,112881,0.005935701275754316,1350
63139,1.36120166702627,103.8914116670026,HOUGANG,34129,27817,6312,30973,0.0016286751146245906,370
63239,1.35891911967242,103.8878789953328,HOUGANG,35266,48895,-13629,42080,0.0022127223331095723,503
63229,1.35757166659958,103.88511923530164,HOUGANG,31625,38249,-6624,34937,0.001837116923760673,418
63339,1.36811854812783,103.88451259380585,HOUGANG,31287,58017,-26730,44652,0.002347967624002106,534
63329,1.36862870083779,103.882008479663,HOUGANG,30120,64022,-33902,47071,0.0024751676079325254,563
63391,1.3708774514093,103.88018734514235,HOUGANG,75861,161802,-85941,118831,0.006248574324280979,1421
63381,1.37095163322641,103.88239574095121,HOUGANG,116493,116580,-87,116536,0.006127894719849265,1394
63371,1.37115666339413,103.88514405987183,HOUGANG,40306,54650,-14344,47478,0.002496569176125862,568
64411,1.37353273194871,103.88503406200056,HOUGANG,236129,270772,-34643,253450,0.013327340193123123,3032
64509,1.37423994629457,103.87882971768626,HOUGANG,10237,9714,523,9975,0.0005245224637064634,119
64519,1.37380837246167,103.88110955631065,HOUGANG,9085,5224,3861,7154,0.00037618383011088117,85
64419,1.37339164793235,103.88521854859373,HOUGANG,305944,284062,21882,295003,0.015512350913363192,3529
63379,1.370839,103.885214,HOUGANG,84532,55093,29439,69812,0.003670973657771993,835
63389,1.37063835467565,103.882445169636,HOUGANG,142511,122197,20314,132354,0.006959663775579475,1583
63399,1.37022333300436,103.8802849999831,HOUGANG,159569,67388,92181,113478,0.005967093748018251,1357
63321,1.36913602302795,103.88132215113495,HOUGANG,95253,60118,35135,77685,0.004084965172234247,929
63331,1.36836866548657,103.88492703491212,HOUGANG,81917,50602,31315,66259,0.003484143751651786,792
63221,1.35799327947024,103.8855063915276,HOUGANG,210561,66172,144389,138366,0.007275797013855491,1655
63231,1.35901223241231,103.88763070107527,HOUGANG,80162,39399,40763,59780,0.0031434539228443496,715
63131,1.36120884403234,103.89033109494885,HOUGANG,19402,29589,-10187,24495,0.0012880378695227892,293
64201,1.36172833297814,103.89420777799334,HOUGANG,157713,159939,-2226,158826,0.008351659631142132,1900
64231,1.36479332441286,103.8968501202605,HOUGANG,59440,40128,19312,49784,0.0026178272013195566,595
64301,1.36722334223088,103.89904601013104,HOUGANG,13861,26279,-12418,20070,0.0010553549720890949,240
64311,1.37014334916955,103.90023200745897,HOUGANG,6132,4137,1995,5134,0.00026996474472872013,61
64321,1.37229075864076,103.90046238900685,HOUGANG,17789,17660,129,17724,0.0009319935986700108,212
64071,1.37514056376267,103.89724811886428,HOUGANG,154209,82942,71267,118575,0.006235112895638486,1418
64039,1.37668753222312,103.89393761218089,HOUGANG,147276,90639,56637,118957,0.006255199871190955,1423
64371,1.37447444021165,103.89289427356103,HOUGANG,11405,31072,-19667,21238,0.0011167727402704632,254
64381,1.37288245131287,103.89170384962591,HOUGANG,143069,455356,-312287,299212,0.015733675730379783,3580
64391,1.37145414929063,103.88976573946181,HOUGANG,44811,36179,8632,40495,0.00212937715967852,484
63261,1.35896472197244,103.88913833298105,HOUGANG,38568,32455,6113,35511,0.00186729997079501,424
63271,1.35639501261001,103.88997632456076,HOUGANG,77873,93982,-16109,85927,0.004518360074075718,1028
63281,1.3541297220266,103.8898808330127,HOUGANG,171930,199416,-27486,185673,0.009763374376317814,2221
63291,1.35225002342978,103.88785804760475,HOUGANG,216472,142396,74076,179434,0.009435304636862714,2147
63301,1.35149473186732,103.88531199399267,HOUGANG,179674,80593,99081,130133,0.006842875365364732,1557
62221,1.35090140225527,103.88255343944132,HOUGANG,116543,46862,69681,81702,0.00429619391776897,977
62219,1.35192637119856,103.88032033542545,HOUGANG,21241,24667,-3426,22954,0.0012070063791396655,274
62059,1.35170138896709,103.87859583297927,HOUGANG,172124,223435,-51311,197779,0.010399952716731893,2366
62229,1.35108999372692,103.88212234368397,HOUGANG,50103,131156,-81053,90629,0.004765608657970233,1084
63309,1.35205944401441,103.88581055600547,HOUGANG,97066,189551,-92485,143308,0.0075356656871023425,1714
63299,1.35263165715857,103.88833522800789,HOUGANG,109173,167422,-58249,138297,0.007272168738166694,1654
63289,1.3540116670036,103.88966083299925,HOUGANG,78939,100254,-21315,89596,0.0047112896900495535,1072
63279,1.35623805601182,103.88983499998875,HOUGANG,58213,60522,-2309,59367,0.0031217368524172045,710
63269,1.35875481272429,103.88905763623875,HOUGANG,27375,41340,-13965,34357,0.0018066183744925278,411
64399,1.37121818386818,103.8892571932248,HOUGANG,32993,50106,-17113,41549,0.002184800385417529,497
64389,1.37313809346006,103.89156818388481,HOUGANG,212605,116887,95718,164746,0.008662955168499752,1971
64379,1.37468500843171,103.89266306129461,HOUGANG,24023,6667,17356,15345,0.0008068969629649806,183
64031,1.37699995735935,103.893660799245,HOUGANG,112867,143929,-31062,128398,0.0067516426360884705,1536
64079,1.37500833299826,103.89774777801168,HOUGANG,65088,128845,-63757,96966,0.005098831600577537,1160
67629,1.38027975053648,103.89060499842181,SENGKANG,19457,68934,-49477,44195,0.003415487153417315,418
66569,1.383159,103.882572,HOUGANG,22344,42622,-20278,32483,0.0017080765101330378,388
66559,1.381952,103.881758,HOUGANG,22602,18720,3882,20661,0.0010864319421192222,247
66589,1.381992,103.8794283,HOUGANG,66157,55442,10715,60799,0.0031970367188861423,727
66579,1.38402973472559,103.88070409002009,HOUGANG,111738,113587,-1849,112662,0.005924185444220309,1348
66609,1.385071,103.882087,HOUGANG,126811,89393,37418,108102,0.005684403746525926,1293
67621,1.38095802621952,103.89025132744938,SENGKANG,45603,21894,23709,33748,0.002608119933330185,319
63099,1.35357948490597,103.89097410968795,HOUGANG,274130,169487,104643,221808,0.011663486579428896,2654
63089,1.35653228525134,103.89213497244268,HOUGANG,87947,57056,30891,72501,0.0038123712422237902,867
63079,1.35978917315442,103.89296017669749,HOUGANG,132709,93039,39670,112874,0.005935333189814873,1350
63241,1.36409785233957,103.89213557756084,HOUGANG,313947,272848,41099,293397,0.01542790148211381,3510
66439,1.37393762072692,103.87551294197841,SERANGOON,100299,46623,53676,73461,0.007460170482784058,872
66429,1.37352182697727,103.87243744452265,SERANGOON,144775,45047,99728,94911,0.009638478113441387,1126
66101,1.37094045484466,103.87325896613375,SERANGOON,140813,141235,-422,141024,0.014321382531739821,1674
66379,1.35339155862192,103.87285801649963,SERANGOON,156602,177556,-20954,167079,0.01696734082156624,1983
66359,1.35080698547823,103.87328604946424,SERANGOON,556448,876096,-319648,716272,0.07273942952103432,8503
66109,1.3699792245468,103.8746132395795,SERANGOON,144498,147507,-3009,146002,0.014826912386537591,1733
66421,1.37365500000249,103.87340722201968,SERANGOON,62611,195722,-133111,129166,0.013117169390279,1533
66431,1.37297644274866,103.87526422817183,SERANGOON,65871,77207,-11336,71539,0.007264985994852898,849
65009,1.40370629859822,103.90224337575333,PUNGGOL,1801092,1987270,-186178,1894181,0.2574330075590276,44909
65341,1.40194694990354,103.9009230492748,PUNGGOL,77040,36855,40185,56947,0.007739512476085414,1350
65331,1.4028650002354,103.89851804993967,PUNGGOL,58549,22319,36230,40434,0.0054952753869042725,958
65431,1.40238938083661,103.89673562171807,PUNGGOL,217539,88451,129088,152995,0.02079313592074539,3627
59479,1.42034812354505,103.84865147425622,YISHUN,33653,13002,20651,23327,0.0011698693765389108,259
59759,1.41755035688919,103.84631099997239,YISHUN,40814,10923,29891,25868,0.0012973027406999848,287
59749,1.41499035691552,103.8443330000306,YISHUN,19323,5213,14110,12268,0.0006152508900149766,136
59739,1.41416011900146,103.84214688104234,YISHUN,21706,5068,16638,13387,0.000671369715082368,148
59509,1.41252120911526,103.83794497908777,YISHUN,5908,4205,1703,5056,0.00025356280566642657,56
59729,1.41113811897325,103.83350299996852,YISHUN,6136,3464,2672,4800,0.0002407241825947088,53
59031,1.41277747172151,103.83083958669692,YISHUN,82578,102784,-20206,92681,0.004648032909804209,1030
59041,1.41625420109094,103.832591612732,YISHUN,230397,998032,-767635,614214,0.03080336731004718,6826
59051,1.41968270185637,103.83429674432547,YISHUN,189826,237335,-47509,213580,0.010711223108037063,2373
59061,1.42556399229911,103.83495820649408,YISHUN,160142,93825,66317,126983,0.006368308099671647,1411
59079,1.42926606883551,103.83516195358482,YISHUN,810225,546142,264083,678183,0.03401146840096404,7537
59091,1.43165245434506,103.83510814544051,YISHUN,479564,156976,322588,318270,0.01596151783217041,3537
59251,1.43669132626001,103.83368337352286,YISHUN,184234,135967,48267,160100,0.008029154506961017,1779
59521,1.44003661278482,103.83171080846517,YISHUN,38736,59650,-20914,49193,0.002467071815496148,546
58549,1.442578,103.830142,SEMBAWANG,324855,137577,187278,231216,0.030490976245058747,3129
58611,1.446533,103.82993,SEMBAWANG,8573,15235,-6662,11904,0.0015698073715537822,161
58609,1.447964,103.830401,SEMBAWANG,9203,28347,-19144,18775,0.0024759016633839268,254
58519,1.44973306,103.831062,SEMBAWANG,64983,98897,-33914,81940,0.010805612905335762,1109
58059,1.45079007708143,103.82866296034206,SEMBAWANG,81560,43747,37813,62653,0.008262192645325867,848
58049,1.44919525191106,103.82703542333945,SEMBAWANG,30621,9002,21619,19811,0.002612521323744286,268
58339,1.44936138505812,103.82430573345592,SEMBAWANG,31175,74419,-43244,52797,0.006962459660275961,714
58211,1.44926202582359,103.81979401898032,SEMBAWANG,251257,824174,-572917,537715,0.07090969176705662,7278
58251,1.44803148822713,103.81895207486829,SEMBAWANG,241718,490119,-248401,365918,0.04825443328160424,4952
58009,1.44748179252514,103.81941391689068,SEMBAWANG,373880,74241,299639,224060,0.0295472983594036,3032
58259,1.44777267175187,103.81895151565973,SEMBAWANG,434470,159330,275140,296900,0.03915287370751999,4018
58219,1.44953463697186,103.8199297231716,SEMBAWANG,543805,197003,346802,370404,0.048846012235635686,5013
58331,1.44974129560526,103.82397609690102,SEMBAWANG,99061,40986,58075,70023,0.009234091194414524,947
58041,1.44939346470038,103.8268558037182,SEMBAWANG,11824,46996,-35172,29410,0.003878363138222172,398
58051,1.45087972197488,103.82843083296738,SEMBAWANG,46268,81111,-34843,63689,0.008398812305686227,862
58511,1.44964,103.8315,SEMBAWANG,124511,79029,45482,101770,0.013420639802001715,1377
58601,1.448139,103.831129,SEMBAWANG,26988,12042,14946,19515,0.0025734871350698977,264
58619,1.44637,103.830152,SEMBAWANG,8180,12179,-3999,10179,0.0013423277247182417,137
58541,1.44284,103.830351,SEMBAWANG,99072,382200,-283128,240636,0.03173321292516935,3257
59529,1.44035052900307,103.8318142995419,YISHUN,35375,20364,15011,27869,0.001397654634319154,309
59259,1.43716783426775,103.83379791523895,YISHUN,56768,100598,-43830,78683,0.00394602101231239,874
59099,1.43272835490407,103.83522544787667,YISHUN,58007,130937,-72930,94472,0.00473785312043486,1049
59073,1.42868146490253,103.83546942999693,YISHUN,486977,762130,-275153,624553,0.03132187716918191,6941
59059,1.42054602879781,103.83497942324875,YISHUN,256781,145158,111623,200969,0.01007877046914084,2233
59049,1.41700998157675,103.83339984073773,YISHUN,835042,200832,634210,517937,0.025974991866782433,5756
59039,1.41342871609658,103.83156300557019,YISHUN,86160,73104,13056,79632,0.003993614189246219,885
59721,1.41153711897875,103.83367988105842,YISHUN,4285,10837,-6552,7561,0.0003791907384580402,84
59501,1.41289253257843,103.83810681040471,YISHUN,34189,30326,3863,32257,0.001617716657907817,358
59731,1.4141292303869,103.84149524920335,YISHUN,28760,45812,-17052,37286,0.0018699253900471484,414
59741,1.41554882267258,103.84464056605152,YISHUN,31221,56436,-25215,43828,0.002198012390575187,487
59751,1.41725535689777,103.84590800002533,YISHUN,29750,91402,-61652,60576,0.0030379391843452248,673
59471,1.42111543044621,103.84901971560181,YISHUN,73767,95155,-21388,84461,0.00423579274711077,938
65439,1.40172529138051,103.89631809709375,PUNGGOL,110337,224731,-114394,167534,0.022769092018341503,3972
65339,1.4031330662473,103.8980438895579,PUNGGOL,47046,58818,-11772,52932,0.007193844704447172,1254
65349,1.40222088604884,103.90077963354756,PUNGGOL,12763,55963,-43200,34363,0.0046701822258542695,814
68191,1.402289,103.85963,SELETAR,15,115,-100,65,0.00011274993625292065,0
68181,1.40407,103.858281,SELETAR,3315,6055,-2740,4685,0.008126668482229742,2
68189,1.403739,103.858254,SELETAR,2260,5400,-3140,3830,0.006643573166902863,1
68199,1.402553,103.859906,SELETAR,5,335,-330,170,0.0002948844486614848,0
65259,1.405351944,103.9018719,PUNGGOL,210836,185571,25265,198203,0.026937232712830477,4699
65409,1.40624496856359,103.89957451783918,PUNGGOL,59236,33337,25899,46286,0.006290604851319463,1097
65141,1.40454805557377,103.89716388800268,PUNGGOL,166853,43326,123527,105089,0.014282361258702653,2491
75359,1.37438650022455,103.93147946559002,PAYA LEBAR,197396,305386,-107990,251391,0.35393673682298726,0
75369,1.37079630405212,103.93056528604264,TAMPINES,23810,51279,-27469,37544,0.0015670307155383467,407
75319,1.367593,103.931091,TAMPINES,46470,44440,2030,45455,0.001897224088397495,493
75299,1.364115,103.931119,TAMPINES,42834,40261,2573,41547,0.0017341099813145027,450
75379,1.35943002306953,103.9309897702735,TAMPINES,23363,15317,8046,19340,0.0008072228329030371,209
75171,1.3575,103.9313,TAMPINES,14774,10232,4542,12503,0.00052185662253292,135
75159,1.35405115206724,103.93146643451303,TAMPINES,191181,132038,59143,161609,0.006745319276247514,1753
75039,1.3506577199911,103.92956819494434,TAMPINES,45314,77267,-31953,61290,0.0025581534347790666,664
75241,1.34844803009871,103.92980219657613,TAMPINES,98319,130023,-31704,114171,0.004765327717444294,1238
75231,1.34707779444929,103.93265533979496,TAMPINES,287509,301766,-14257,294637,0.01229771012502855,3196
75221,1.34567355960876,103.93595044893453,TAMPINES,97758,81415,16343,89586,0.003739186386166054,971
75051,1.34503394154132,103.94008153173421,TAMPINES,464432,384752,79680,424592,0.017721838524713873,4605
96119,1.33373145315305,103.9537488312858,TAMPINES,158349,270272,-111923,214310,0.00894498062665201,2324
96229,1.3312261583979,103.95799531596526,TAMPINES,17873,17890,-17,17881,0.0007463263430785525,193
96311,1.3329118846906,103.9607070021467,TAMPINES,539,27705,-27166,14122,0.0005894312743669436,153
96301,1.33450022538919,103.9617438259165,TAMPINES,33112,119859,-86747,76485,0.0031923701331224813,829
96401,1.33678578456278,103.96599671694322,TAMPINES,107,54495,-54388,27301,0.0011395031313901664,296
97009,1.34188800000174,103.96713700000154,TAMPINES,5383,5376,7,5379,0.00022451145905819217,58
96361,1.33649110063455,103.96643704167043,TAMPINES,64477,8953,55524,36715,0.0015324294886264222,398
96309,1.33427655612286,103.96175810276951,TAMPINES,135416,45408,90008,90412,0.0037736623975402994,980
96319,1.33311988623192,103.96095897791456,TAMPINES,19046,1166,17880,10106,0.00042180940792751256,109
96221,1.33090140156137,103.95796397863708,TAMPINES,21299,14716,6583,18007,0.0007515853956610646,195
96111,1.33365307929022,103.95337833802823,TAMPINES,251914,123045,128869,187479,0.007825094596164865,2033
75059,1.34471168546511,103.9402168928283,TAMPINES,274354,328697,-54343,301525,0.012585204999539207,3270
75229,1.34499782605889,103.93676608938834,TAMPINES,82219,75940,6279,79079,0.003300639834702134,857
75239,1.34675259898315,103.93257655832721,TAMPINES,263090,206241,56849,234665,0.009794568049803061,2545
75249,1.34791499671757,103.93017010145029,TAMPINES,93109,50023,43086,71566,0.0029870583898417144,776
75031,1.35080696753697,103.92946243284943,TAMPINES,117929,76898,41031,97413,0.004065873723970194,1056
75151,1.35451781224143,103.93145206236657,TAMPINES,141860,209448,-67588,175654,0.007331536685147367,1905
75179,1.357,103.9317,TAMPINES,30220,34347,-4127,32283,0.0013474444009621896,350
75371,1.35909826524265,103.93052373888251,TAMPINES,20154,27388,-7234,23771,0.0009921661820547101,257
75291,1.364015,103.930753,TAMPINES,46209,42804,3405,44506,0.001857614239978416,482
75311,1.367478,103.930734,TAMPINES,64437,77996,-13559,71216,0.0029724499104458475,772
75361,1.3706441545828,103.93030234430374,PAYA LEBAR,63411,38793,24618,51102,0.07194718635563045,0
75351,1.37364163782281,103.93077504301999,TAMPINES,227312,164289,63023,195800,0.008172400759173457,2124
65149,1.40444046572287,103.89692479945528,PUNGGOL,91946,190226,-98280,141086,0.019174615997348175,3345
65401,1.40653182138609,103.89871180015278,PUNGGOL,29084,74103,-45019,51593,0.007011864842374045,1223
67101,1.39143144034973,103.89956953538392,SENGKANG,53679,57525,-3846,55602,0.0042970452925514095,526
67111,1.39105369405739,103.90237246307768,SENGKANG,52029,73702,-21673,62865,0.004858345964466105,595
67121,1.38949805550873,103.90518999989366,SENGKANG,39225,47166,-7941,43195,0.003338204946076726,408
67131,1.38767805568948,103.90527388892869,SENGKANG,59467,38064,21403,48765,0.003768666840963805,461
67141,1.38602111109914,103.90353194446361,SENGKANG,76985,60171,16814,68578,0.0052998592150028875,649
67151,1.38353305558266,103.90215499999188,SENGKANG,37127,18328,18799,27727,0.002142803762932501,262
67161,1.38212499997742,103.89926833301193,SENGKANG,9279,12394,-3115,10836,0.0008374299987426184,102
65019,1.38151407829697,103.89749237919405,SENGKANG,146042,97517,48525,121779,0.009411349927729544,1152
64029,1.37781617357511,103.89688283812272,HOUGANG,98723,67880,30843,83301,0.004380275263078909,996
64021,1.37788950153352,103.89663845377325,HOUGANG,78640,103289,-24649,90964,0.004783224199357869,1088
65011,1.38159696830765,103.89720951783346,SENGKANG,105492,143923,-38431,124707,0.009637632230822788,1180
67169,1.38253470078472,103.89922222337448,SENGKANG,11762,14657,-2895,13209,0.0010208206767618353,125
67159,1.38436793782529,103.90225602044251,SENGKANG,36847,64465,-27618,50656,0.003914807495044858,479
67139,1.38715714684677,103.90417577185805,SENGKANG,77995,91315,-13320,84655,0.006542325262417531,801
67129,1.38936844113699,103.90498892005203,SENGKANG,56295,60726,-4431,58510,0.004521781951497841,553
67119,1.39050824371994,103.90323582065614,SENGKANG,118327,46460,71867,82393,0.00636751290941312,779
67109,1.39102885574104,103.89998669813552,SENGKANG,96051,73534,22517,84792,0.006552912924823192,802
77009,1.373564,103.950478,PASIR RIS,1917954,1721397,196557,1819675,0.1715834902298281,12446
78109,1.375403,103.954556,PASIR RIS,183446,204975,-21529,194210,0.018312736965411358,1328
78081,1.37368803498525,103.95635599319583,PASIR RIS,96803,85599,11204,91201,0.008599659770261477,623
78071,1.37031163160495,103.95718010428234,PASIR RIS,78322,109045,-30723,93683,0.008833696190364206,640
98099,1.36457166700645,103.96328361098551,PASIR RIS,134021,96119,37902,115070,0.010850350870757867,787
98019,1.3622609999684,103.96338699998489,PASIR RIS,167410,107823,59587,137616,0.012976291695752276,941
76249,1.35836639849151,103.95947435534286,TAMPINES,261699,276770,-15071,269234,0.01123742669047654,2920
76239,1.3564927293972,103.95754826481253,TAMPINES,242805,286989,-44184,264897,0.011056406761505471,2873
76039,1.35506418976437,103.9555498102644,TAMPINES,272689,487259,-214570,379974,0.01585954957132878,4121
76109,1.35296639979416,103.9551184525466,TAMPINES,412805,287403,125402,350104,0.014612820201172952,3797
96129,1.3474583546739,103.95795115114063,TAMPINES,115408,151178,-35770,133293,0.005563451554609334,1445
96189,1.3452978033151,103.95793622236005,TAMPINES,69418,38866,30552,54142,0.002259806547002908,587
96199,1.34304235304377,103.9579441304978,TAMPINES,8839,23956,-15117,16397,0.0006843863904400776,177
96209,1.34020664808373,103.95943155475572,TAMPINES,22599,18887,3712,20743,0.000865781966024183,225
95909,1.33849391556302,103.96049907137146,TAMPINES,10033,9671,362,9852,0.00041120782573736924,106
96039,1.33560833298198,103.95843416703279,TAMPINES,22752,13772,8980,18262,0.0007622287163637675,198
96029,1.33371794723789,103.95679798964366,TAMPINES,3670,7168,-3498,5419,0.00022618099956057695,58
96019,1.33138833299802,103.95370361097966,TAMPINES,22108,17114,4994,19611,0.0008185339698066939,212
85109,1.32945523179761,103.95134864429271,BEDOK,40515,14160,26355,27337,0.0011132830340788737,149
85099,1.32684437763421,103.94645987386455,BEDOK,598504,613464,-14960,605984,0.02467833727633801,3312
84101,1.32298200464523,103.94421518494586,BEDOK,76522,119995,-43473,98258,0.004001498495172183,537
84071,1.32067138376849,103.9426000755741,BEDOK,54968,59953,-4985,57460,0.0023400242578985285,314
84081,1.3204380811482,103.94022038903293,BEDOK,45107,36498,8609,40802,0.0016616371348899368,223
84141,1.32021707852141,103.93816948878941,BEDOK,34947,29212,5735,32079,0.0013063981581818117,175
84111,1.31958802627855,103.93574197184712,BEDOK,158122,121409,36713,139765,0.005691846334931916,763
84151,1.31656999665769,103.93334015990408,BEDOK,53195,115328,-62133,84261,0.0034314790113955437,460
91079,1.3013063985688,103.8952666584497,MARINE PARADE,10077,7514,2563,8795,0.0022376675133929298,54
91069,1.30061892627157,103.89304722999233,MARINE PARADE,30383,21590,8793,25986,0.006611486981583704,162
91059,1.30052638901127,103.88831333297796,MARINE PARADE,43053,29626,13427,36339,0.00924554858091935,226
91049,1.30069808015377,103.88643299699929,MARINE PARADE,18712,31241,-12529,24976,0.006354517773109928,155
91091,1.30314976548218,103.88436845345339,KALLANG,180917,101788,79129,141352,0.014354831797467615,735
80271,1.30511398524943,103.8831203007559,KALLANG,12505,82666,-70161,47585,0.004832437256512086,247
01129,1.30350269187301,103.85864530718491,ROCHOR,31186,61604,-30418,46395,0.011968387668962058,78
01059,1.30075679526626,103.85611040457583,DOWNTOWN CORE,34861,216677,-181816,125769,0.02619857288820888,41
01119,1.2996041093804,103.85512934079571,DOWNTOWN CORE,155187,165289,-10102,160238,0.03337870955848273,53
01019,1.29698951191332,103.85302201172507,DOWNTOWN CORE,51740,84301,-32561,68020,0.014169047442978542,22
04159,1.29489484954945,103.85108138663934,DOWNTOWN CORE,24880,48002,-23122,36441,0.007590918228015011,12
04149,1.29276132399953,103.84983741344308,DOWNTOWN CORE,44935,93580,-48645,69257,0.014426723298417595,22
04229,1.29044830830726,103.84875123545265,DOWNTOWN CORE,28480,37779,-9299,33129,0.006901005185804706,10
04239,1.28882717929599,103.8474938118651,SINGAPORE RIVER,47072,120043,-72971,83557,0.06348505661891188,109
05059,1.28676420118491,103.84575036447065,SINGAPORE RIVER,17181,56195,-39014,36688,0.027874860959999026,48
05049,1.28531114761754,103.84455070696784,OUTRAM,348174,354308,-6134,351241,0.11231079343173662,1025
05039,1.28293819129834,103.84254276754574,OUTRAM,587919,446477,141442,517198,0.16537624520288724,1509
05019,1.28118388885484,103.84105000000471,OUTRAM,65684,57764,7920,61724,0.019736509729161775,180
10011,1.2777380589964,103.83749709165197,BUKIT MERAH,73351,108005,-34654,90678,0.0052843325582846825,799
10041,1.27605834770353,103.83519065305671,BUKIT MERAH,199143,272997,-73854,236070,0.013757166975829472,2080
10499,1.27585400417691,103.83401000002084,BUKIT MERAH,38088,32688,5400,35388,0.0020622638409821385,311
10049,1.27623302424393,103.83483786772155,BUKIT MERAH,181149,120899,60250,151024,0.008801043696181938,1331
10017,1.27832046633393,103.83762574759974,BUKIT MERAH,167420,92826,74594,130123,0.007583021300444184,1146
05013,1.28406979945936,103.84299874303983,OUTRAM,500706,647441,-146735,574073,0.18356226669932424,1675
05023,1.28692928357498,103.84540375642477,SINGAPORE RIVER,80302,59923,20379,70112,0.053269795345275074,92
04222,1.28898962180798,103.84708976365569,SINGAPORE RIVER,391364,250848,140516,321106,0.24397037460263432,422
04142,1.2930982644668,103.84965994500728,DOWNTOWN CORE,91749,85971,5778,88860,0.018510166947707633,29
01012,1.29684825487647,103.85253591654006,DOWNTOWN CORE,97217,113208,-15991,105212,0.02191640428654305,34
01112,1.30009212839081,103.85520027125814,ROCHOR,529566,296319,233247,412942,0.10652548638423387,695
01121,1.30393809691048,103.85867999243207,ROCHOR,160654,122176,38478,141415,0.03648042983524668,238
80279,1.30514903438296,103.88342000727887,KALLANG,132826,35247,97579,84036,0.008534174577876424,437
91099,1.30320972763591,103.88471920227425,MARINE PARADE,46732,93973,-47241,70352,0.01789930470747236,438
91041,1.30100303875383,103.8865107850326,MARINE PARADE,46477,39718,6759,43097,0.010964952453063684,268
91051,1.30046470843446,103.88946922448878,MARINE PARADE,21759,35059,-13300,28409,0.007227958656961881,177
91061,1.30060777798346,103.89256694398647,MARINE PARADE,16469,29073,-12604,22771,0.005793510738768664,142
91071,1.30171305700998,103.89599084091456,MARINE PARADE,5621,16224,-10603,10922,0.0027788294009411687,68
84159,1.31664972197451,103.93304055596909,BEDOK,111865,46742,65123,79303,0.003229567416013349,433
84119,1.31968902766581,103.93506805500876,BEDOK,178314,189473,-11159,183893,0.007488932837760775,1005
84149,1.32047933475714,103.93839375752798,BEDOK,40650,47475,-6825,44062,0.0017943986921601979,240
84089,1.3206814195738,103.9400309260245,BEDOK,62604,72748,-10144,67676,0.0027560647698841078,369
84079,1.32099303797206,103.94325305782594,BEDOK,45930,32149,13781,39039,0.001589840010513412,213
84109,1.32350836424044,103.9441209521673,BEDOK,131119,83604,47515,107361,0.004372212745427148,586
85091,1.32754912682416,103.94636119805759,BEDOK,566241,601761,-35520,584001,0.0237830927016533,3191
85101,1.32931499760121,103.95071705887575,BEDOK,12411,39011,-26600,25711,0.0010470651530600256,140
96011,1.33167675245972,103.9535299850262,TAMPINES,25046,21823,3223,23434,0.0009781003033221185,254
96021,1.33397805603359,103.95663722202137,TAMPINES,4653,5777,-1124,5215,0.0002176663429984146,56
96031,1.33590500003397,103.95837000001772,TAMPINES,11920,14649,-2729,13284,0.0005544544008419827,144
95901,1.33857587129254,103.96020709087523,TAMPINES,11097,12134,-1037,11615,0.0004847928233799781,125
96201,1.34068848247811,103.95925914106326,TAMPINES,20386,23257,-2871,21821,0.0009107760825634526,236
96191,1.34285666698806,103.95774638900882,TAMPINES,23885,14769,9116,19327,0.0008066802322397621,209
96181,1.34563053684832,103.95770528781159,TAMPINES,36647,79703,-43056,58175,0.0024281379681558523,631
96121,1.34719360554366,103.95776019526973,TAMPINES,167948,111446,56502,139697,0.005830744989041136,1515
76101,1.35303315550855,103.95480210652737,TAMPINES,451945,550537,-98592,501241,0.020921053773896133,5437
76031,1.35507956918888,103.95529781026745,TAMPINES,355291,256293,98998,305792,0.012763303232631102,3317
76231,1.35666908955685,103.95736200626966,TAMPINES,188492,147809,40683,168150,0.007018330886899984,1824
76241,1.35845802746258,103.95917058122039,TAMPINES,282242,197133,85109,239687,0.010004178859877469,2600
98011,1.36221388889515,103.96291600002557,PASIR RIS,122110,148075,-25965,135092,0.012738294949443136,924
98091,1.36432808773556,103.9631266198707,PASIR RIS,64674,83984,-19310,74329,0.007008740157057108,508
78079,1.36995048419615,103.95691414168428,PASIR RIS,72134,63896,8238,68015,0.006413371117359836,465
78089,1.37361141865113,103.95608873577847,PASIR RIS,78754,92361,-13607,85557,0.008067467362904587,585
78101,1.375053,103.954039,PASIR RIS,198383,179600,18783,188991,0.017820619287524115,1292
10051,1.2774116353284,103.83214410914843,BUKIT MERAH,72095,98798,-26703,85446,0.004979433597732559,753
10061,1.27860472196885,103.82948638898173,BUKIT MERAH,63379,89496,-26117,76437,0.0044544269586625895,673
10071,1.28045309423663,103.82638920754815,BUKIT MERAH,219695,292840,-73145,256267,0.014934163211737584,2258
10371,1.28365072319387,103.824502653383,BUKIT MERAH,162595,94925,67670,128760,0.007503591391569462,1134
10171,1.28736808047078,103.82346004890803,BUKIT MERAH,42774,55213,-12439,48993,0.002855106034849042,431
10181,1.28850399420484,103.82109741719866,BUKIT MERAH,87817,93476,-5659,90646,0.0052824677328378805,798
10191,1.28860026020096,103.81903121724014,BUKIT MERAH,139095,170203,-31108,154649,0.009012293453827475,1363
10201,1.28928144532567,103.81662854691157,BUKIT MERAH,334296,261418,72878,297857,0.017357853534628032,2625
11539,1.29117049549107,103.80786180498694,BUKIT MERAH,17908,25617,-7709,21762,0.0012681978554157708,191
11529,1.28903120647732,103.8060909305284,BUKIT MERAH,30384,123851,-93467,77117,0.004494054499407131,679
14041,1.2732727805917,103.81247079301698,BUKIT MERAH,73694,114856,-41162,94275,0.005493950593664267,830
14349,1.27579029839825,103.81339813671549,BUKIT MERAH,17172,65875,-48703,41523,0.002419785844611205,365
14339,1.276660654539,103.81124504785828,BUKIT MERAH,35571,97836,-62265,66703,0.003887170368063512,587
14329,1.274547,103.809425,BUKIT MERAH,64052,89369,-25317,76710,0.004470336250755619,676
14491,1.27278805556375,103.8079488888896,BUKIT MERAH,39431,16707,22724,28069,0.0016357432958213982,247
14501,1.27687216148362,103.80648081848618,BUKIT MERAH,42028,58928,-16900,50478,0.0029416455907396964,444
14391,1.27790999999895,103.80858611110148,BUKIT MERAH,47816,42111,5705,44963,0.002620254580142418,396
14331,1.27694611110347,103.8110680555484,BUKIT MERAH,50932,21549,29383,36240,0.0021119148185032408,319
14341,1.2759338888633,103.81347388887318,BUKIT MERAH,28997,5759,23238,17378,0.0010127167692038997,153
14049,1.27324166755337,103.81304231999674,BUKIT MERAH,68313,28176,40137,48244,0.002811457464234833,425
11521,1.2885710102662,103.80543003047167,QUEENSTOWN,181989,64855,117134,123422,0.010718285435595455,1028
11531,1.29108833302538,103.80753083302794,BUKIT MERAH,33051,21170,11881,27110,0.0015798568082125515,238
10209,1.28954631749853,103.81672885450702,BUKIT MERAH,357266,400232,-42966,378749,0.022071899160962583,3338
10199,1.28875723330649,103.81936618662205,BUKIT MERAH,119841,60748,59093,90294,0.005261954652923059,795
10189,1.28858805222806,103.82183192865197,BUKIT MERAH,116936,111188,5748,114062,0.006647053753535228,1005
10179,1.28722333302937,103.82395833301354,BUKIT MERAH,47844,36407,11437,42125,0.0024548678733291676,371
10379,1.28373603376667,103.82489520929732,BUKIT MERAH,77471,150453,-72982,113962,0.006641226174013972,1004
10079,1.2803950142786,103.82708906887606,BUKIT MERAH,319304,234164,85140,276734,0.01612689391235309,2439
10069,1.27855472196877,103.83008250001669,BUKIT MERAH,59657,45695,13962,52676,0.0030697357886169075,464
10059,1.27739664167497,103.83275178077875,BUKIT MERAH,54759,44006,10753,49382,0.0028777753191867286,435
06011,1.28165999996967,103.83801388886192,BUKIT MERAH,170358,91363,78995,130860,0.007625970561515842,1153
06051,1.28475980959972,103.83405671725487,BUKIT MERAH,145420,186904,-41484,166162,0.0096832226841097,1464
06071,1.28685859481289,103.83360028266564,BUKIT MERAH,36537,25700,10837,31118,0.0018134261954244992,274
06081,1.28837086415387,103.83349881780524,BUKIT MERAH,37243,37761,-518,37502,0.002185458872061494,330
10221,1.29032906602668,103.83111793441608,BUKIT MERAH,25658,30146,-4488,27902,0.0016260112380209004,245
10231,1.29041850946952,103.82788100149519,BUKIT MERAH,79470,98025,-18555,88747,0.005171801997729225,782
10389,1.28875832991208,103.82573455047122,BUKIT MERAH,124415,85616,38799,105015,0.006119832634247181,925
10169,1.28599961406266,103.82748123930962,BUKIT MERAH,854163,1011404,-157241,932783,0.05435867108575907,8221
10121,1.28259924598805,103.82890541983913,BUKIT MERAH,33808,122975,-89167,78391,0.004568297862507935,690
10501,1.28105845355429,103.82528065411316,BUKIT MERAH,28890,24962,3928,26926,0.00156913406189344,237
10369,1.28037471151153,103.82387343933006,BUKIT MERAH,75654,167262,-91608,121458,0.007078061534927336,1070
14039,1.27663637861466,103.82345826768822,BUKIT MERAH,86518,134622,-48104,110570,0.006443554676652963,974
14291,1.27468440821038,103.82132649422054,BUKIT MERAH,101357,135421,-34064,118389,0.006899213119419983,1043
14269,1.27758480623244,103.81999451121168,BUKIT MERAH,78782,141050,-62268,109916,0.0064054423065839465,968
14259,1.27784501068205,103.81865821941,BUKIT MERAH,51934,39816,12118,45875,0.002673402105376274,404
14279,1.27591552267791,103.81920892602811,BUKIT MERAH,213590,206997,6593,210293,0.012254991802635267,1853
14319,1.273483,103.820637,BUKIT MERAH,24380,39266,-14886,31823,0.0018545106310493553,280
14489,1.272377,103.82159,BUKIT MERAH,26043,40582,-14539,33312,0.0019412832901208599,293
14309,1.27128899958763,103.82302593897191,BUKIT MERAH,37701,48824,-11123,43262,0.00252112745248585,381
14379,1.27243833303297,103.82379361102515,BUKIT MERAH,119324,109055,10269,114189,0.006654454779527224,1006
14031,1.27624277802151,103.82306027800865,BUKIT MERAH,194477,73088,121389,133782,0.0077962524351269475,1179
10361,1.28038092060065,103.82353025808791,BUKIT MERAH,153207,63723,89484,108465,0.0063208841277305194,956
10129,1.28231999999009,103.8285719444802,BUKIT MERAH,85088,24385,60703,54736,0.0031897839267547847,482
10151,1.28572048365401,103.8285292287095,BUKIT MERAH,88593,133401,-44808,110997,0.006468438441208727,978
10161,1.28593135445772,103.82668969231534,BUKIT MERAH,911421,618536,292885,764978,0.04457970127011513,6742
10381,1.28906972186602,103.82559411728036,BUKIT MERAH,51988,79794,-27806,65891,0.003839850422350912,580
10239,1.29060688839488,103.82865297447873,BUKIT MERAH,109999,94723,15276,102361,0.005965168673753042,902
10229,1.29052137840164,103.83178189529583,BUKIT MERAH,20252,20029,223,20140,0.0011736745155809954,177
06069,1.28623157720487,103.83496162445665,OUTRAM,47057,46668,389,46862,0.01498432245039173,136
06049,1.28474856880259,103.83517705055233,BUKIT MERAH,67621,46271,21350,56946,0.0033185734341745466,501
06029,1.28177041153491,103.8383828488293,BUKIT MERAH,110977,224668,-113691,167822,0.009779960504162553,1479
10141,1.28583847140468,103.83238179897589,BUKIT MERAH,215311,137900,77411,176605,0.010291796813514484,1556
10241,1.2906166672167,103.82362326803131,BUKIT MERAH,59048,56314,2734,57681,0.0033614061436557795,508
10261,1.29090335842692,103.82047232884216,BUKIT MERAH,20877,30126,-9249,25501,0.0014860910537155393,224
10271,1.29115999997607,103.81757666701353,BUKIT MERAH,21969,55172,-33203,38570,0.0022476974213485102,339
10479,1.29668100002552,103.81547381025995,QUEENSTOWN,6803,15355,-8552,11079,0.0009621289911114878,92
10469,1.29668400003303,103.81216918970023,QUEENSTOWN,38245,49994,-11749,44119,0.003831407975345043,367
11499,1.29685053610951,103.80788663334461,QUEENSTOWN,52328,37002,15326,44665,0.0038788240263556823,372
11489,1.298817,103.804395,QUEENSTOWN,49712,40607,9105,45159,0.003921724262984356,376
11469,1.30113503392421,103.80188584326886,QUEENSTOWN,10684,10000,684,10342,0.0008981260065055517,86
11439,1.30606472198412,103.80029777801455,QUEENSTOWN,89928,56828,33100,73378,0.0063723351484591345,611
11429,1.30454000002017,103.7983633329984,QUEENSTOWN,18733,16051,2682,17392,0.0015103662255989707,144
11471,1.29951892595663,103.80315156606572,QUEENSTOWN,22477,20264,2213,21370,0.0018558260258193424,178
11481,1.29811518922625,103.8060054035445,QUEENSTOWN,25373,35662,-10289,30517,0.002650175144123953,254
11491,1.29710202847016,103.8076364994003,QUEENSTOWN,24124,36357,-12233,30240,0.002626119748281559,251
10461,1.29680597432594,103.81169140516062,TANGLIN,38357,32602,5755,35479,0.017758066058063706,179
10471,1.29679993078344,103.81468220659576,TANGLIN,7550,5570,1980,6560,0.0032834328290227434,33
10279,1.29151373164978,103.81757660887743,BUKIT MERAH,40403,19731,20672,30067,0.0017521783346560967,265
10269,1.29125331927458,103.82057583280772,BUKIT MERAH,16898,11245,5653,14071,0.0008199987144359576,124
10249,1.29088138899671,103.82407777797806,BUKIT MERAH,56830,45614,11216,51222,0.0029850027823778423,451
10149,1.28606797463712,103.83283384311112,BUKIT MERAH,194652,242880,-48228,218766,0.012748762615471303,1928
10009,1.28210155945393,103.81722480263163,BUKIT MERAH,710780,682917,27863,696848,0.04060937134228329,6142
10659,1.28362333298689,103.81472833301791,BUKIT MERAH,31760,6108,25652,18934,0.0011033939065546458,166
10101,1.28506195168861,103.8137833011436,BUKIT MERAH,95060,103324,-8264,99192,0.005780492678724433,874
10111,1.28592835098556,103.80935410958449,BUKIT MERAH,136251,180818,-44567,158534,0.009238694918228279,1397
10131,1.28619141382394,103.80686549059318,BUKIT MERAH,167815,101181,66634,134498,0.007837977904499142,1185
08137,1.30073968408393,103.84100500816844,ORCHARD,47263,17439,29824,32351,0.009131555251963859,8
08019,1.29624633745957,103.84407009228418,MUSEUM,28863,26181,2682,27522,0.0145023836033802,7
04329,1.29197057108024,103.84328384973516,SINGAPORE RIVER,35692,40289,-4597,37990,0.028864096376754335,49
06161,1.28901705678419,103.83994286096711,OUTRAM,63880,67503,-3623,65691,0.021004974736218752,191
06151,1.28870976841461,103.83737276969174,SINGAPORE RIVER,44267,97180,-52913,70723,0.05373402179660955,92
14389,1.27428160509375,103.82500895193466,BUKIT MERAH,68448,173031,-104583,120739,0.007036161238169504,1064
14381,1.27413014152159,103.82554290547176,BUKIT MERAH,183967,109924,74043,146945,0.008563336727509899,1295
14029,1.27247333301883,103.82418777803016,BUKIT MERAH,115913,60019,55894,87966,0.005126288601668215,775
14019,1.2684889249437,103.82571717446542,BUKIT MERAH,11091,20398,-9307,15744,0.0009174941198265736,138
14519,1.25352193438281,103.82570322127442,SOUTHERN ISLANDS,2784,46163,-43379,24473,0.526221859074978,484
14521,1.256432,103.820911,SOUTHERN ISLANDS,78,6508,-6430,3293,0.0708065452512525,65
14539,1.251427,103.818545,SOUTHERN ISLANDS,17789,12827,4962,15308,0.32915475089771434,302
14529,1.253226,103.821217,SOUTHERN ISLANDS,6836,31,6805,3433,0.07381684477605521,67
14011,1.26795444401606,103.8255261109799,BUKIT MERAH,9224,9492,-268,9358,0.0005453448915991537,82
14021,1.27132972198996,103.82478361101728,BUKIT MERAH,13988,28312,-14324,21150,0.0012325330687456828,186
06149,1.28984045728104,103.83411526676929,BUKIT MERAH,38008,25129,12879,31568,0.001839650303270152,278
06159,1.28909385421188,103.8368794036018,SINGAPORE RIVER,96106,39346,56760,67726,0.051456956862649755,89
06169,1.28937078931125,103.83998944937589,SINGAPORE RIVER,70457,58174,12283,64315,0.04886534241829311,84
04321,1.2921400077773,103.84303646191061,SINGAPORE RIVER,61606,49452,12154,55529,0.04218990280875998,72
04311,1.29464575337351,103.8439214229312,MUSEUM,16439,9100,7339,12769,0.006728469451041413,3
08011,1.29706985017362,103.84361028672502,MUSEUM,13269,15184,-1915,14226,0.0074962179035566725,3
11019,1.28679632523156,103.80565677295323,BUKIT MERAH,107922,141289,-33367,124605,0.007261455462461268,1098
10139,1.28635135443034,103.8081000223439,BUKIT MERAH,201075,235351,-34276,218213,0.012716536100718757,1923
10119,1.28598009010704,103.81122515087834,BUKIT MERAH,122451,92727,29724,107589,0.006269834531124316,948
10651,1.28329993019059,103.81547665017668,BUKIT MERAH,14033,68739,-54706,41386,0.002411802060667084,364
14009,1.26703502614245,103.81901469907409,BUKIT MERAH,230973,282479,-51506,256726,0.01496091180174015,2262
52499,1.32603759751245,103.85537211273478,NOVENA,28862,61593,-32731,45227,0.007812332661965943,385
52451,1.3253199216809,103.85731928602708,NOVENA,137084,102479,34605,119781,0.02069049502692955,1020
52129,1.32544666698102,103.85938111100755,NOVENA,142457,152954,-10497,147705,0.02551397607260441,1258
52109,1.32697666701265,103.8581711110213,NOVENA,122149,98182,23967,110165,0.01902946531287678,938
52099,1.32652328466497,103.85488905075222,NOVENA,98675,9895,88780,54285,0.009376975668402088,462
50159,1.32456066077113,103.85326623915941,NOVENA,161138,23248,137890,92193,0.015925053289066845,785
50211,1.32306968689436,103.8525670514891,NOVENA,201108,162117,38991,181612,0.031370936816613064,1547
50221,1.32143805851672,103.8530377626759,NOVENA,200065,58581,141484,129323,0.02233874227438083,1101
50129,1.3189880880064,103.84929028517206,NOVENA,48049,58321,-10272,53185,0.009186966029731326,453
50119,1.31829503182752,103.8458185038638,NOVENA,24727,52781,-28054,38754,0.006694212306406089,330
50069,1.31702163080967,103.84164776289317,NOVENA,91497,42055,49442,66776,0.011534621483526164,569
40129,1.31453779264106,103.84082845008946,NOVENA,83346,29070,54276,56208,0.009709147064005611,478
40189,1.31223181292182,103.83816095637219,NEWTON,242071,223541,18530,232806,0.2850475128164001,1228
40179,1.31133173990881,103.83686949960516,NEWTON,41982,19240,22742,30611,0.03748008820572848,161
09047,1.30446065207443,103.83294467208566,ORCHARD,196765,549013,-352248,372889,0.10525351631632875,96
09037,1.3023400420296,103.83701253388183,ORCHARD,231330,215635,15695,223482,0.0630811483669558,58
04167,1.29250006522444,103.85145315468638,DOWNTOWN CORE,204130,135524,68606,169827,0.03537616612906082,56
04249,1.29043039362749,103.85026216508201,DOWNTOWN CORE,83186,103690,-20504,93438,0.01946379675061789,30
05029,1.28712283362119,103.84819780822524,SINGAPORE RIVER,72110,107921,-35811,90015,0.06839172506853229,118
05131,1.284073056,103.8453381,OUTRAM,139712,139698,14,139705,0.044671263879731485,407
05069,1.28027629959632,103.84029791443083,OUTRAM,145695,19926,125769,82810,0.026478847298812242,241
10399,1.27588166292683,103.83019454205221,BUKIT MERAH,43896,53017,-9121,48456,0.0028238119328198963,427
14221,1.27359332247784,103.82893371728431,BUKIT MERAH,31700,74918,-43218,53309,0.003106624366986459,469
14231,1.27100999999332,103.82667222202473,BUKIT MERAH,50137,42815,7322,46476,0.002708425858299024,409
14271,1.27568194286532,103.81914854048932,BUKIT MERAH,33620,63989,-30369,48804,0.002844091909553868,430
14281,1.27699671573899,103.81804377490617,BUKIT MERAH,105854,86217,19637,96035,0.005596515993238376,846
14059,1.276025,103.815613,BUKIT MERAH,38276,37853,423,38064,0.002218209868970954,335
14399,1.27763662023223,103.80858552939208,BUKIT MERAH,59917,66501,-6584,63209,0.0036835547395908212,557
14509,1.275651111,103.8068061,BUKIT MERAH,34886,27722,7164,31304,0.0018242654933340358,275
14499,1.27291305557456,103.8078211111249,BUKIT MERAH,14461,29970,-15509,22215,0.0012945967906470611,195
14359,1.27289055599998,103.81035027797056,BUKIT MERAH,32029,29128,2901,30578,0.0017819572660097158,269
14351,1.27275000000424,103.81036111111034,BUKIT MERAH,21685,16406,5279,19045,0.00110986251982324,167
14051,1.275847,103.815157,BUKIT MERAH,34902,35828,-926,35365,0.0020609234976922495,311
14299,1.27488820445716,103.82127132943862,BUKIT MERAH,67709,38266,29443,52987,0.003087859560928014,467
14239,1.27178138152481,103.8271423936315,BUKIT MERAH,94202,61711,32491,77956,0.00454294789159047,687
14229,1.27370670186653,103.82857888915174,BUKIT MERAH,68150,31739,36411,49944,0.0029105263160961884,440
10391,1.27627105343758,103.8312563936613,BUKIT MERAH,90034,52222,37812,71128,0.004145040761879098,626
10018,1.27900819665099,103.83860360621959,BUKIT MERAH,174256,283496,-109240,228876,0.013337930905070303,2017
05012,1.28154583300728,103.84087722199499,OUTRAM,73815,121366,-47551,97590,0.031204814731205007,284
05022,1.28571089865595,103.84437203405348,OUTRAM,364577,323349,41228,343963,0.10998362218864093,1004
04223,1.29084476137495,103.84857901022669,DOWNTOWN CORE,85605,75429,10176,80517,0.01677226099627026,26
04143,1.29411640848293,103.85020606905503,MUSEUM,60631,24197,36434,42414,0.02234954211735222,11
09011,1.30211335092372,103.83431672376756,ORCHARD,112444,82936,29508,97690,0.02757446856555746,25
09023,1.30323727330942,103.83254180023424,ORCHARD,148457,45852,102605,97154,0.02742317452163138,25
09212,1.30702238421536,103.83265522662566,ORCHARD,274850,130363,144487,202606,0.05718858407404376,52
40171,1.3109517198906,103.83582101192815,NEWTON,14651,23126,-8475,18888,0.023126454739466187,99
40181,1.312641,103.838298,NEWTON,218284,169430,48854,193857,0.2373583829113033,1023
40121,1.31458164930261,103.84053190286843,NOVENA,33505,86837,-53332,60171,0.010393699971325818,512
50061,1.31743500021924,103.84143789916804,NOVENA,24663,60976,-36313,42819,0.0073963842893121304,364
50111,1.31875833024702,103.8465549576423,NOVENA,47034,16213,30821,31623,0.0054624316397140875,269
50121,1.31930304159281,103.84933923160258,NOVENA,62004,57710,4294,59857,0.010339460856287074,510
50229,1.32095764720403,103.85283489560972,NOVENA,120487,312030,-191543,216258,0.03735554949060143,1842
50991,1.32337986005569,103.85626145335385,NOVENA,138924,348922,-209998,243923,0.04213429190317109,2078
50231,1.31872472201456,103.85492583301323,KALLANG,48888,42722,6166,45805,0.004651671504350869,238
50241,1.31724802771626,103.8572754498738,KALLANG,14012,20905,-6893,17458,0.001772926124286813,90
60101,1.31783421341306,103.86004042483177,KALLANG,77340,92499,-15159,84919,0.008623846577403591,442
60121,1.32008815616383,103.86179781146463,KALLANG,714643,689896,24747,702269,0.07131808090140772,3655
60141,1.32258753768004,103.86385682733587,KALLANG,160967,195801,-34834,178384,0.01811557187276772,928
60211,1.328454,103.870465,TOA PAYOH,164406,153847,10559,159126,0.01200899191438618,1463
70361,1.32859972197494,103.87346222198977,GEYLANG,5766,12194,-6428,8980,0.0005997851059465621,33
70341,1.32626471325242,103.87490379761162,GEYLANG,29614,47651,-18037,38632,0.002580278197430689,144
70321,1.32247982189668,103.87674093245458,GEYLANG,15209,11736,3473,13472,0.0008998112413487844,50
70311,1.32335569812186,103.87901421599854,GEYLANG,5885,6169,-284,6027,0.0004025506496146915,22
80239,1.31846350927886,103.88051104388848,GEYLANG,2878,46968,-44090,24923,0.0016646374382523572,92
80229,1.3172897212662,103.87810554835914,GEYLANG,33726,169839,-136113,101782,0.006798143391253116,379
80269,1.31501452983156,103.8783609867014,GEYLANG,6602,5656,946,6129,0.0004093633534906992,22
70319,1.32319846234081,103.87904763225207,GEYLANG,3334,9152,-5818,6243,0.00041697755194035493,23
70329,1.32229748021835,103.87682676312598,GEYLANG,13845,18975,-5130,16410,0.0010960438294635951,61
70349,1.32598493140196,103.87447469442839,GEYLANG,29844,36977,-7133,33410,0.002231494475464882,124
70359,1.32768812063773,103.87256886396422,GEYLANG,6100,7707,-1607,6903,0.0004610597534909931,25
60219,1.32829192682419,103.8704918465033,TOA PAYOH,142787,111143,31644,126965,0.009581851227392389,1167
60139,1.32204861560134,103.86628982237994,KALLANG,266366,223368,42998,244867,0.024867172715989178,1274
60119,1.31880431510648,103.86409707876385,KALLANG,353007,450817,-97810,401912,0.04081568819248262,2092
60099,1.315304,103.861404,KALLANG,82805,100377,-17572,91591,0.009301413486628107,476
07329,1.31284472583438,103.85989088288474,KALLANG,205987,210952,-4965,208469,0.021170817745672334,1085
07231,1.309658889,103.8573711,KALLANG,60071,129619,-69548,94845,0.009631869530185747,493
07211,1.31313747728456,103.8563561439714,KALLANG,477149,254744,222405,365946,0.03716320446089255,1904
07221,1.314966,103.857819,KALLANG,79310,72357,6953,75833,0.007701128811034592,394
50249,1.317187,103.857005,KALLANG,35842,51188,-15346,43515,0.004419113317581663,226
50239,1.318301,103.8552335,KALLANG,15760,18924,-3164,17342,0.0017611458842583293,90
76529,1.35741,103.940604,TAMPINES,31711,34348,-2637,33029,0.0013785813313316655,358
76519,1.35920624506603,103.93921870101352,TAMPINES,20610,67733,-47123,44171,0.0018436318382709436,479
75271,1.36024833439953,103.93601495043112,TAMPINES,62788,212682,-149894,137735,0.005748854027399163,1494
75509,1.361373,103.934576,TAMPINES,662,2536,-1874,1599,6.673988158283124e-05,17
75519,1.364004,103.934527,TAMPINES,1294,21156,-19862,11225,0.0004685148034817265,121
75461,1.36591354266845,103.93360116833266,TAMPINES,5440,10145,-4705,7792,0.0003252264898645535,84
75381,1.373188889,103.9266,PAYA LEBAR,17861,30340,-12479,24100,0.03393071095398798,0
75391,1.37507,103.9213,PAYA LEBAR,16833,19435,-2602,18134,0.025531100101228967,0
74011,1.37329165833159,103.92045032835671,PAYA LEBAR,2835,1855,980,2345,0.0033015567297552625,0
74021,1.37042803443167,103.92278161130189,PAYA LEBAR,4838,6022,-1184,5430,0.007644969314529243,0
74031,1.367627,103.925697,PAYA LEBAR,5230,3965,1265,4597,0.006472177520974389,0
74041,1.36850444400102,103.92978611099927,PAYA LEBAR,5260,3781,1479,4520,0.006363768195519738,0
75511,1.364262,103.934773,TAMPINES,54645,3056,51589,28850,0.0012041560873450165,312
75501,1.361552,103.934734,TAMPINES,9652,1133,8519,5392,0.00022505405972146722,58
75279,1.3604749400553,103.93620400344062,TAMPINES,268901,66305,202596,167603,0.0069954999205298725,1818
76511,1.359138,103.939389,TAMPINES,75644,18810,56834,47227,0.0019711847326531404,512
76521,1.357468889,103.940775,TAMPINES,6584,40078,-33494,23331,0.0009738012365284777,253
75019,1.35737133106172,103.9416488042812,TAMPINES,22659,20470,2189,21564,0.0009000492848356304,233
76559,1.355625,103.943569,TAMPINES,4679,238,4441,2458,0.00010259326387154422,26
76191,1.3569438864901,103.94477445426702,TAMPINES,592360,460550,131810,526455,0.021973448629574375,5710
76149,1.35370728527221,103.94636710560508,TAMPINES,158818,197464,-38646,178141,0.00743534036588314,1932
76139,1.35162691843499,103.94385009279503,TAMPINES,195924,173353,22571,184638,0.007706515481982987,2002
76111,1.35157455446947,103.94023387732626,TAMPINES,49273,37196,12077,43234,0.0018045228520025805,468
76121,1.35003333718868,103.93817517168992,TAMPINES,65945,64861,1084,65403,0.0027298239369367805,709
76281,1.34758373789104,103.93848632286071,TAMPINES,40863,42783,-1920,41823,0.0017456298107809576,453
75259,1.34913805600656,103.92798027801848,TAMPINES,136044,82741,53303,109392,0.004565859365921874,1186
62071,1.34252980960729,103.88002892732668,TOA PAYOH,49967,95575,-45608,72771,0.005491914272977369,669
62081,1.34384211984571,103.87773872280378,SERANGOON,4193,2762,1431,3477,0.0003530990970534048,41
62091,1.34366730308769,103.8751907687792,TOA PAYOH,1626,4424,-2798,3025,0.00022829204869737312,27
66069,1.34350264971893,103.86263251306754,TOA PAYOH,12533,14457,-1924,13495,0.0010184466767507604,124
52449,1.34044945876465,103.85000305578686,TOA PAYOH,27601,25253,2348,26427,0.001994404618487762,243
52179,1.34069018059141,103.84803485038329,TOA PAYOH,110911,263995,-153084,187453,0.014146786579989648,1723
52209,1.33925873230713,103.84678448871398,TOA PAYOH,51275,51156,119,51215,0.003865116454226765,470
52199,1.33547301693721,103.84663861149124,TOA PAYOH,17856,41171,-23315,29513,0.0022273002423820075,271
50161,1.32665700619185,103.84366009715464,NOVENA,76944,112733,-35789,94838,0.01638194010205245,808
50171,1.32663388888255,103.84641000001729,NOVENA,150213,204347,-54134,177280,0.03062264431232057,1510
52401,1.32830186081857,103.85082868868597,NOVENA,15531,58362,-42831,36946,0.006381905554845418,314
52411,1.328301,103.853806,NOVENA,9469,64870,-55401,37169,0.0064204256906850365,316
52049,1.32721151783698,103.85978762051998,NOVENA,46224,89200,-42976,67712,0.011696302412431466,576
52119,1.32782675894568,103.8581076205424,NOVENA,5107,5874,-767,5490,0.0009483208330022559,46
52419,1.32803305599299,103.85391750002599,NOVENA,51876,24450,27426,38163,0.006592125309629343,325
52409,1.32801971174787,103.85105250762084,NOVENA,48142,20297,27845,34219,0.005910854386977085,291
52479,1.32749617656635,103.84578619081431,NOVENA,32346,26952,5394,29649,0.005121450706317648,252
50169,1.32647401158756,103.84420812253344,NOVENA,89924,64084,25840,77004,0.013301365651093936,656
51011,1.327841667,103.8406111,NOVENA,83596,82857,739,83226,0.014376129261829827,709
52191,1.33636138602833,103.84608389640735,TOA PAYOH,46868,51755,-4887,49311,0.003721424533327658,453
52201,1.33918030742933,103.84650759525915,TOA PAYOH,63050,63261,-211,63155,0.004766209697680198,580
52171,1.3409498853794,103.8477798112237,TOA PAYOH,156829,63026,93803,109927,0.008296019846993763,1010
52441,1.34083165668042,103.84976000739448,TOA PAYOH,44404,61721,-17317,53062,0.004004506673712401,487
66061,1.34405111099275,103.86346055601665,SERANGOON,17290,15283,2007,16286,0.0016538889544468651,193
62099,1.34412749517611,103.87562115587856,TOA PAYOH,4469,3494,975,3981,0.0003004398829303281,36
62089,1.34383983323818,103.8782509427123,SERANGOON,56388,31296,25092,43842,0.004452278002017651,520
62079,1.34296635529936,103.87976646424752,SERANGOON,39230,18604,20626,28917,0.0029366024128539853,343
75251,1.3494983330038,103.92783361101397,TAMPINES,119118,187392,-68274,153255,0.006396635742324455,1662
76289,1.34738728491099,103.93814569319093,TAMPINES,61495,46669,14826,54082,0.0022573022362493305,586
76129,1.34988214931301,103.93791583710507,TAMPINES,100288,63046,37242,81667,0.0034086591052064287,885
76119,1.35188664573357,103.94009028016603,TAMPINES,35322,84623,-49301,59972,0.002503142075225488,650
76131,1.35184112001279,103.94254133694142,TAMPINES,144740,182823,-38083,163781,0.0068359753255270075,1776
76141,1.35366689109025,103.94609060451609,TAMPINES,362202,287754,74448,324978,0.013564098334599957,3525
76199,1.35660016333768,103.94535428432116,TAMPINES,413441,643937,-230496,528689,0.022066692466632565,5735
76551,1.355401,103.943599,TAMPINES,155,16562,-16407,8358,0.00034885048797329805,90
93131,1.31277833350682,103.93415826027375,BEDOK,46627,52040,-5413,49333,0.0020090570260165004,269
01541,1.29886465442254,103.85734583628746,DOWNTOWN CORE,14802,102833,-88031,58817,0.012251997404493809,19
01559,1.30168731070562,103.85752923961614,ROCHOR,31508,31351,157,31429,0.00810765073925657,52
01549,1.30069868861162,103.85873120467069,ROCHOR,10201,4517,5684,7359,0.0018983805335896495,12
93139,1.31278641539067,103.9338525622476,BEDOK,37320,35161,2159,36240,0.0014758524035197126,198
55509,1.38113241525166,103.8455558816965,ANG MO KIO,1199477,1065972,133505,1132724,0.06720213257684728,10905
55209,1.37863166702811,103.84468444401317,ANG MO KIO,79179,42408,36771,60793,0.0036067208302678114,585
54059,1.3762849891494,103.84498299185917,ANG MO KIO,32720,29388,3332,31054,0.0018423685072810458,298
54049,1.37350472194557,103.84532571985918,ANG MO KIO,57100,99508,-42408,78304,0.004645611631162974,753
54039,1.37091786093364,103.84563650364578,ANG MO KIO,116710,92448,24262,104579,0.006204452119628534,1006
54019,1.36618666697727,103.84418333302729,ANG MO KIO,272602,207969,64633,240285,0.01425560368300464,2313
53169,1.362165,103.842512,BISHAN,106792,65143,41649,85967,0.011280325543946649,984
53379,1.36018670154842,103.84386020713477,BISHAN,189654,115884,73770,152769,0.020045878686277125,1750
53389,1.35804473736933,103.84516933880761,BISHAN,418608,213058,205550,315833,0.04144263563368853,3618
53399,1.35464002820911,103.8470163249439,BISHAN,138857,47213,91644,93035,0.012207766782382501,1065
53231,1.35089997844732,103.84797987894204,BISHAN,364347,1501261,-1136914,932804,0.12239967416212744,10687
53211,1.34707169454274,103.84712672325323,BISHAN,52382,82010,-29628,67196,0.008817252611479276,769
52021,1.34431313758435,103.84766088139544,BISHAN,45513,57956,-12443,51734,0.0067883764897057695,592
52031,1.34404852974216,103.85026155631283,BISHAN,108892,99472,9420,104182,0.013670441865127895,1193
66071,1.34375516528836,103.86737312632222,SERANGOON,15707,13321,2386,14514,0.0014739373870098123,172
61029,1.336175,103.870563,TOA PAYOH,49512,41548,7964,45530,0.003436078339567404,418
07359,1.31368253065979,103.86071451807119,KALLANG,71895,69559,2336,70727,0.007182595142194606,368
81011,1.31532318660502,103.88335173265862,GEYLANG,149324,142462,6862,145893,0.009744370652768572,544
81031,1.31580283030533,103.88604854571838,GEYLANG,125869,147047,-21178,136458,0.009114195544237858,509
81051,1.31662343087312,103.89033436777706,GEYLANG,67430,85721,-18291,76575,0.005114537248091091,285
82011,1.31736957951855,103.89480000904068,GEYLANG,199996,177350,22646,188673,0.012601698807823575,703
82032,1.31776416388008,103.89719868894,GEYLANG,221642,242991,-21349,232316,0.015516667780966761,866
82061,1.31876162629115,103.9022689641617,GEYLANG,636295,296903,339392,466599,0.031164713880797317,1740
83299,1.31574389673514,103.90586328314893,BEDOK,53120,99702,-46582,76411,0.0031117924394410803,417
83319,1.31268833645873,103.90714010649674,BEDOK,13767,42354,-28587,28060,0.0011427267782219408,153
83309,1.31045482788745,103.90806851700533,BEDOK,8816,46289,-37473,27552,0.0011220387809540596,150
92279,1.30633786714639,103.90964863731638,BEDOK,13767,56163,-42396,34965,0.0014239287883296564,191
92061,1.30585304722559,103.91059595623031,BEDOK,150245,129879,20366,140062,0.005703941482940894,765
92239,1.30438002120698,103.91266110940761,MARINE PARADE,97559,253319,-155760,175439,0.04463606036181265,1094
92071,1.3067937735779,103.91498055803811,BEDOK,135457,187652,-52195,161554,0.006579190375226921,882
92081,1.30751338586806,103.91754269765207,BEDOK,61563,76185,-14622,68874,0.002804852605960725,376
93011,1.30822971200422,103.92151900444857,BEDOK,65842,89263,-23421,77552,0.003158258984485672,423
93021,1.30867772794032,103.92426998119757,BEDOK,45587,99927,-54340,72757,0.0029629854669669903,397
93121,1.31088501240237,103.92498850824487,BEDOK,10366,13333,-2967,11849,0.00048254346383292144,64
94009,1.31795981372922,103.95256713632443,BEDOK,29252,20759,8493,25005,0.0010183137237861593,136
93129,1.31135799079971,103.92481225868325,BEDOK,10793,14337,-3544,12565,0.0005117021371474942,68
93029,1.30851455788092,103.92471047692146,BEDOK,104818,51830,52988,78324,0.0031896982244282,428
93019,1.30787614366531,103.92111718654822,BEDOK,115656,66696,48960,91176,0.0037130882655439655,498
92089,1.3071917122941,103.91764721757994,MARINE PARADE,92351,37655,54696,65003,0.016538385602396885,405
92211,1.30595638898755,103.91698861102066,MARINE PARADE,49112,36651,12461,42881,0.010909996661944539,267
92221,1.30496423786628,103.91493558885941,MARINE PARADE,112042,38526,73516,75284,0.019154128604692816,469
92231,1.30425500081318,103.9123223933556,MARINE PARADE,122880,42633,80247,82756,0.02105519189748099,516
92271,1.30610999016148,103.90952850508972,BEDOK,55065,13373,41692,34219,0.0013935483828929648,187
83301,1.30887166700305,103.90817888897894,MARINE PARADE,61977,16329,45648,39153,0.009961500415221532,244
83311,1.31241970275404,103.90692990251455,MARINE PARADE,45666,16689,28977,31177,0.007932206943155358,194
83291,1.31473309387158,103.90589521764187,GEYLANG,77775,33411,44364,55593,0.00371312398606762,207
82069,1.31709537499354,103.90295147896967,GEYLANG,229990,236073,-6083,233031,0.015564423499313286,869
82049,1.31634170548514,103.89891621295058,GEYLANG,393890,442548,-48658,418219,0.027933354924706597,1560
82029,1.31569833821527,103.89559528546464,GEYLANG,407503,290014,117489,348758,0.023293970376359812,1301
82109,1.3151892235607,103.89331774481381,GEYLANG,95418,83299,12119,89358,0.005968329342669588,333
81069,1.314729,103.89069,GEYLANG,99620,62416,37204,81018,0.005411290613984251,302
81049,1.314075556,103.8873525,GEYLANG,135394,105477,29917,120435,0.00804399991477441,449
81029,1.313616389,103.8849306,GEYLANG,148572,127250,21322,137911,0.009211243178863734,514
07361,1.31167636068313,103.86189483728585,KALLANG,81939,47517,34422,64728,0.006573373935893965,336
07351,1.31351833300073,103.86054527803076,KALLANG,83257,89914,-6657,86585,0.008793035197123022,450
61011,1.3333927981396,103.86946402615806,TOA PAYOH,40520,40829,-309,40674,0.0030696035665180015,374
61021,1.33627668492978,103.87018878876424,TOA PAYOH,41448,50003,-8555,45725,0.0034507946865082267,420
66089,1.34238715725246,103.86947751046722,TOA PAYOH,13522,16892,-3370,15207,0.001147648656046596,139
66079,1.34326097186022,103.86743994816177,TOA PAYOH,7856,9917,-2061,8886,0.0006706126098263991,81
52039,1.34333817728421,103.85130310024304,TOA PAYOH,133595,130235,3360,131915,0.009955420034351728,1213
53219,1.34606111102286,103.8465836110301,BISHAN,76487,36102,40385,56294,0.007386725675793416,645
53239,1.35100305612802,103.8476587818646,BISHAN,571895,184752,387143,378323,0.04964238138777121,4334
53391,1.35444291744538,103.84696320325273,BISHAN,44389,101859,-57470,73124,0.009595106553393217,837
53381,1.35830432828214,103.84496212009292,BISHAN,269351,511499,-242148,390425,0.0512303686355854,4473
53371,1.35994333341045,103.84379568310376,BISHAN,93143,138494,-45351,115818,0.015197282025065583,1327
53161,1.362208,103.842055,BISHAN,77313,80552,-3239,78932,0.010357214464094325,904
54011,1.36567044820875,103.84341042482097,ANG MO KIO,213971,257062,-43091,235516,0.013972668943157171,2267
54031,1.37008641040706,103.84534111753092,ANG MO KIO,100338,132109,-31771,116223,0.006895266149987924,1118
54041,1.373558,103.844975,ANG MO KIO,34952,51338,-16386,43145,0.002559702107510811,415
54051,1.376558,103.844964,ANG MO KIO,14600,23364,-8764,18982,0.0011261621370905136,182
55201,1.37859113966821,103.8443777268119,ANG MO KIO,113932,141005,-27073,127468,0.007562408349523422,1227
54009,1.36968769913339,103.84856716193268,ANG MO KIO,2503261,2041353,461908,2272307,0.13481119519785764,21877
54248,1.36875490594243,103.84661006967286,ANG MO KIO,464704,253176,211528,358940,0.021295155278014382,3455
53321,1.36135,103.8402947,BISHAN,37003,45075,-8072,41039,0.0053850114578620455,470
53209,1.36099828733018,103.83852670989133,BISHAN,8275,40426,-32151,24350,0.0031951321669373236,278
53199,1.35754830843445,103.83899242953868,BISHAN,31790,48918,-17128,40354,0.005295127863022125,462
53189,1.35496333303081,103.83681111097366,BISHAN,20961,26534,-5573,23747,0.0031160083600928388,272
53179,1.353043,103.835842,BISHAN,12114,39329,-27215,25721,0.0033750305735439383,294
53039,1.35144681735328,103.83591070615076,BISHAN,73173,66638,6535,69905,0.009172719266108978,800
53029,1.34939240848355,103.83729222566143,BISHAN,37862,87296,-49434,62579,0.008211424060565534,717
53019,1.34600349626668,103.83871779531225,BISHAN,34802,34697,105,34749,0.00455965698845606,398
51069,1.34125785266365,103.83660435635784,TOA PAYOH,51099,42397,8702,46748,0.0035279989066131566,429
51059,1.3370325833883,103.83735019393414,NOVENA,47861,30415,17446,39138,0.0067605429439057,333
51049,1.3338213150365,103.83795811295674,TOA PAYOH,18229,28783,-10554,23506,0.0017739612881588272,216
51039,1.33165828742218,103.83888866147537,TOA PAYOH,50989,18002,32987,34495,0.0026032840396085573,317
51029,1.3302549684081,103.8397133983878,TOA PAYOH,26930,17306,9624,22118,0.001669211085318512,203
51019,1.32894248973791,103.84066508496021,NOVENA,55816,40650,15166,48233,0.008331577183642589,410
50191,1.32604500002988,103.84902388888725,NOVENA,75856,121648,-45792,98752,0.01705802894365005,841
50201,1.32490472200696,103.85096555600265,NOVENA,52871,79253,-26382,66062,0.011411287954425324,562
60199,1.3179530560114,103.8612788890282,KALLANG,72749,161420,-88671,117084,0.011890324340474122,609
07319,1.31038833299803,103.85870666696984,KALLANG,124009,184427,-60418,154218,0.015661422902695826,802
07419,1.30653024120879,103.8561630249311,ROCHOR,256095,281687,-25592,268891,0.06936505504245882,452
07529,1.30431906266143,103.85501564257024,ROCHOR,136743,131830,4913,134286,0.034641381754806314,226
07589,1.30320609782822,103.85549999983388,ROCHOR,40440,55578,-15138,48009,0.012384746709757507,80
04151,1.29533777799211,103.85113972198121,MUSEUM,37375,28793,8582,33084,0.017433211944416487,8
01013,1.29770970610083,103.8532247463225,ROCHOR,72689,43828,28861,58258,0.015028652415527354,98
01113,1.30117297541547,103.8561140106393,DOWNTOWN CORE,346417,161058,185359,253737,0.05285521304085631,84
07331,1.30824994545395,103.8589096071918,KALLANG,13519,15162,-1643,14340,0.0014562813966246362,74
50209,1.32392782849174,103.85158181192296,NOVENA,94365,70286,24079,82325,0.014220494094154958,701
50199,1.32496824756028,103.85050892832005,NOVENA,59304,37942,21362,48623,0.00839894423735313,414
50189,1.32606229603246,103.84849190712964,NOVENA,107631,54791,52840,81211,0.014028066150992023,692
50179,1.32640402126103,103.8464203281907,NOVENA,96118,68153,27965,82135,0.014187674247475463,699
51021,1.330411111,103.8391331,NOVENA,29126,32862,-3736,30994,0.005353780673601443,264
51031,1.33162906440184,103.83859992029566,TOA PAYOH,31944,42792,-10848,37368,0.002820104884536674,343
51051,1.33635352726982,103.83707802024655,NOVENA,29537,31139,-1602,30338,0.005240465834539606,258
51071,1.34219256998908,103.83596576505084,CENTRAL WATER CATCHMENT,188467,180994,7473,184730,0.3956530213172442,0
53011,1.34555351143315,103.8382633553218,BISHAN,27795,27663,132,27729,0.0036385141625053406,317
53021,1.34967996840542,103.83652457261991,BISHAN,47704,52785,-5081,50244,0.006592863268813096,575
53171,1.35466138896969,103.83630694400975,BISHAN,19644,18597,1047,19120,0.00250886763991136,219
53181,1.35607279929568,103.83781001395549,BISHAN,17957,8911,9046,13434,0.0017627681942766326,153
53191,1.35837944828586,103.83908917392279,BISHAN,30733,13620,17113,22176,0.0029098665681315024,254
53201,1.36128501070806,103.83850250682744,BISHAN,31395,7091,24304,19243,0.002525007321904514,220
53329,1.36153970079158,103.84049549859829,BISHAN,32309,41480,-9171,36894,0.004841117296385446,422
54241,1.36913518643274,103.84618005827467,ANG MO KIO,341875,686149,-344274,514012,0.030495250890852865,4948
50059,1.32489453398384,103.84211744421322,NOVENA,157289,130764,26525,144026,0.02487848019926829,1227
50049,1.32354108650178,103.84189326889334,NOVENA,50010,41622,8388,45816,0.007914074186672379,390
50038,1.32033749274601,103.842832976035,NOVENA,428159,351830,76329,389994,0.06736601729433184,3323
50029,1.316795,103.844656,NOVENA,101132,55744,45388,78438,0.013549069125506548,668
50079,1.31583941661931,103.84693372586678,KALLANG,13908,16380,-2472,15144,0.001537930646477231,78
50089,1.31665493432357,103.85044724612104,KALLANG,105169,93195,11974,99182,0.010072308331940354,516
50321,1.3136845041501,103.85083079337346,KALLANG,34597,26313,8284,30455,0.0030928207764437444,158
50351,1.31216015438698,103.84857773804022,KALLANG,3882,4359,-477,4120,0.0004184016285978732,21
40109,1.30949131269895,103.84770747833439,KALLANG,49750,27331,22419,38540,0.0039138831956703965,200
40019,1.30664404460339,103.84920416709382,ROCHOR,322933,621876,-298943,472404,0.12186473129363837,795
07539,1.30461300741211,103.8520009720951,ROCHOR,112752,109720,3032,111236,0.028695238080497114,187
07518,1.30095828368506,103.85211175034802,ROCHOR,147929,348034,-200105,247981,0.06397096114962561,417
04019,1.29807216909408,103.84975607305783,MUSEUM,30313,51159,-20846,40736,0.021465340399218658,10
10081,1.2822783541702,103.82241744338572,BUKIT MERAH,107095,177660,-70565,142377,0.008297132894978916,1254
10089,1.28292332245689,103.82165660905856,BUKIT MERAH,213553,128506,85047,171029,0.009966850979409239,1507
03223,1.2757033952327,103.84632468221952,DOWNTOWN CORE,94494,42065,52429,68279,0.014222998976170713,22
03151,1.27892124625262,103.84776234627124,DOWNTOWN CORE,94879,38514,56365,66696,0.013893248871756789,22
03021,1.28255524603003,103.84998903789258,DOWNTOWN CORE,46714,36972,9742,41843,0.008716193063165997,13
08079,1.29921444445586,103.84910329217985,MUSEUM,61454,44836,16618,53145,0.02800411222300853,14
07011,1.30099699058522,103.8498101874305,ROCHOR,144993,147923,-2930,146458,0.03778135836234174,246
07021,1.30324521574524,103.84995776766847,ROCHOR,57206,51629,5577,54417,0.014037800447934224,91
07031,1.30572083298412,103.85120583303191,ROCHOR,526299,384918,141381,455608,0.11753191441061463,767
07111,1.30879366465919,103.8531751994068,ROCHOR,381363,253765,127598,317564,0.08192109196478645,534
50251,1.31240499998142,103.85486499997727,KALLANG,117082,33620,83462,75351,0.007652179882640374,392
50261,1.31608827183208,103.85322332407407,KALLANG,9946,29135,-19189,19540,0.0019843611220394276,101
50301,1.31587261047802,103.85178565977449,KALLANG,16519,37414,-20895,26966,0.0027384995914490895,140
50081,1.31634,103.850484,KALLANG,73317,75121,-1804,74219,0.007537220988569308,386
50071,1.31572306955077,103.84707504887322,KALLANG,13439,15507,-2068,14473,0.001469788051140053,75
50021,1.3173533543911,103.84421700922245,NOVENA,123354,215827,-92473,169590,0.02929430420197679,1445
50031,1.321378056,103.8417481,NOVENA,238999,187117,51882,213058,0.03680279417810467,1815
50041,1.32362333324914,103.84161545670325,NOVENA,29950,37923,-7973,33936,0.005861970089028152,289
63319,1.369226,103.878124,HOUGANG,98234,83833,14401,91033,0.0047868524750466655,1089
66339,1.37125183222903,103.87055805068519,SERANGOON,358339,206479,151860,282409,0.028679425625468793,3352
66349,1.37082760014108,103.86541771672718,SERANGOON,81596,55998,25598,68797,0.006986528208220618,816
54309,1.36988835306854,103.86306604022437,SERANGOON,43617,37026,6591,40321,0.004094710581619308,478
54299,1.36890152697813,103.85832656880861,ANG MO KIO,183596,92398,91198,137997,0.008187071774948878,1328
54289,1.369149,103.855987,ANG MO KIO,285765,259854,25911,272809,0.016185184198584234,2626
54279,1.36968919033429,103.85404760550173,ANG MO KIO,69083,72627,-3544,70855,0.004203678127886858,682
54269,1.36921006543476,103.85111893571647,ANG MO KIO,143985,990525,-846540,567255,0.033654046100267586,5461
54239,1.369186093503,103.84332015576305,ANG MO KIO,114752,200684,-85932,157718,0.009357077227775873,1518
54229,1.36960577947339,103.83993274827546,ANG MO KIO,102323,180800,-78477,141561,0.008398516399150258,1362
54219,1.36880777071199,103.83679395921905,ANG MO KIO,111250,124817,-13567,118033,0.007002649643199062,1136
54069,1.36691997150676,103.83405562626137,BISHAN,23789,22671,1118,23230,0.003048169208950884,266
56269,1.36741835425889,103.83233403239235,BISHAN,10439,9631,808,10035,0.0013167618601731433,114
53099,1.36660638165473,103.82842866172699,CENTRAL WATER CATCHMENT,28281,38722,-10441,33501,0.07175213483001677,0
53089,1.363977,103.828198,BISHAN,23921,10411,13510,17166,0.002252469764995733,196
53079,1.36082666696977,103.82864333297208,BISHAN,19682,35523,-15841,27602,0.0036218496128050926,316
53069,1.35777159286274,103.82894351047115,BISHAN,60796,53932,6864,57364,0.007527127787441175,657
53059,1.355471,103.8312231,BISHAN,126780,167721,-40941,147250,0.01932169246741359,1687
53049,1.35362664583092,103.83422172361446,BISHAN,146785,126761,20024,136773,0.01794693272560651,1567
51109,1.32709277800856,103.8397080559738,NOVENA,7415,5625,1790,6520,0.001126238949212151,55
10359,1.28723833324362,103.82259298997768,BUKIT MERAH,12985,44368,-31383,28676,0.0016711167035154233,252
10349,1.284977,103.821011,BUKIT MERAH,91350,283494,-192144,187422,0.010922166090328764,1651
10341,1.28484639603431,103.82059301467888,BUKIT MERAH,149215,51215,98000,100215,0.005840108817226884,883
10351,1.28675501760897,103.82204990181914,BUKIT MERAH,109649,34557,75092,72103,0.004201859662211346,635
53041,1.35307831612792,103.8343639597673,BISHAN,140453,161769,-21316,151111,0.019828321021686485,1731
53051,1.354995,103.8316003,BISHAN,167609,150916,16693,159262,0.02089787019181815,1824
53061,1.3571583010953,103.82883507046125,BISHAN,43993,54688,-10695,49340,0.006474243167009755,565
53071,1.36063333692202,103.82834252087906,BISHAN,29607,21286,8321,25446,0.0033389459186811965,291
53081,1.36319303798878,103.82783467220469,BISHAN,10317,17429,-7112,13873,0.001820372425130246,158
53091,1.36482025993725,103.8279237884758,BISHAN,32226,18605,13621,25415,0.003334878193951215,291
56261,1.367859,103.831724,ANG MO KIO,24460,22589,1871,23524,0.0013956294443639892,226
54061,1.36728801688172,103.83404076959498,ANG MO KIO,55077,40947,14130,48012,0.00284845098124485,462
54211,1.36861222198461,103.83634833298527,ANG MO KIO,85102,101299,-16197,93200,0.005529359981921603,897
54221,1.36995608006054,103.83959341119167,ANG MO KIO,160020,86351,73669,123185,0.0073083069675215955,1185
54231,1.36966012463918,103.84193909880943,ANG MO KIO,210401,105124,105277,157762,0.00935968765523515,1518
54261,1.36946941916508,103.85075454495572,ANG MO KIO,1406177,320077,1086100,863127,0.05120750958279021,8309
54271,1.36996326781056,103.85356664655984,ANG MO KIO,72414,144876,-72462,108645,0.006445679348024384,1046
54281,1.3694902568174,103.85601277845504,ANG MO KIO,151797,249430,-97633,200613,0.01190194736108625,1931
54291,1.36918861426324,103.85886147831553,ANG MO KIO,88650,166516,-77866,127583,0.007569231057655622,1228
54301,1.37019500530585,103.86284675062745,SERANGOON,31942,62377,-30435,47159,0.0047891286505440086,559
66341,1.37114196132937,103.86525341485559,SERANGOON,67117,80243,-13126,73680,0.0074824105467054544,874
66331,1.37173176460482,103.8701543470715,SERANGOON,333707,418870,-85163,376288,0.03821310124591072,4467
63311,1.36990463865149,103.87780647158901,HOUGANG,92423,114975,-22552,103699,0.005452877690616196,1240
54071,1.36433664907741,103.84490672378502,ANG MO KIO,74075,55774,18301,64924,0.0038518043719557742,625
54081,1.36358972199933,103.84786694396756,ANG MO KIO,151785,99990,51795,125887,0.007468610944679881,1212
54091,1.36167975047647,103.85092799797833,ANG MO KIO,47114,34359,12755,40736,0.002416781204115434,392
54101,1.35732097800984,103.85465761724518,ANG MO KIO,81956,66865,15091,74410,0.004414588801017022,716
66091,1.35454666698201,103.86145166702076,SERANGOON,50245,48536,1709,49390,0.005015692954693029,586
66031,1.35465640659199,103.86572364607075,SERANGOON,86241,69341,16900,77791,0.007899894121047286,923
66381,1.35020472197618,103.87122527801795,SERANGOON,184189,106880,77309,145534,0.014779385674595977,1727
66039,1.35475138514216,103.86668854745251,SERANGOON,92972,109553,-16581,101262,0.010283439967161885,1202
66099,1.35427474694456,103.86142199387719,SERANGOON,54996,65925,-10929,60460,0.00613988248715814,717
54109,1.35708169204878,103.85433890252277,BISHAN,23091,40357,-17266,31724,0.0041627257849658995,363
54099,1.36118777797342,103.85104805596895,BISHAN,12613,19315,-6702,15964,0.0020947470190138574,182
54089,1.36297001065247,103.8484911674186,BISHAN,35743,66897,-31154,51320,0.0067340526820214965,588
54079,1.36389805596869,103.84585916699372,BISHAN,14264,21924,-7660,18094,0.00237423907304164,207
80289,1.31607500002964,103.8793280559861,GEYLANG,44593,25123,19470,34858,0.002328208154018403,130
80249,1.31693643112186,103.87985994146072,GEYLANG,126149,159,125990,63154,0.00421813235868031,235
80231,1.31856503177728,103.88010860959606,GEYLANG,28546,748,27798,14647,0.0009782909183518147,54
81201,1.31869302203322,103.88300679740438,GEYLANG,57452,43584,13868,50518,0.0033741585726290006,188
81211,1.31904666371972,103.88666750777982,GEYLANG,226433,146626,79807,186529,0.012458498443998472,695
81221,1.31976331280568,103.89015111975269,GEYLANG,13520,11399,2121,12459,0.0008321517410900019,46
81111,1.31860238558389,103.89211689790608,GEYLANG,757344,585559,171785,671451,0.04484702774754177,2505
82119,1.31619210726015,103.8940879247112,GEYLANG,84850,95043,-10193,89946,0.006007602576778338,335
82099,1.31299461549467,103.89427184817765,GEYLANG,69690,93075,-23385,81382,0.005435602616051572,303
82089,1.31086356037133,103.89430403711837,GEYLANG,32269,53764,-21495,43016,0.0028730908816700794,160
92249,1.30166304472072,103.90118149629421,MARINE PARADE,76232,176904,-100672,126568,0.032202058196147396,789
92041,1.30327282994495,103.90583013375219,MARINE PARADE,396499,557470,-160971,476984,0.12135663458876784,2975
92051,1.30461834682389,103.90783296450577,MARINE PARADE,28147,49654,-21507,38900,0.009897130900623646,242
92229,1.304952,103.916022,MARINE PARADE,54584,122576,-67992,88580,0.022536962858026803,552
92219,1.30633717232202,103.91665220259567,MARINE PARADE,16200,15171,1029,15685,0.003990655480110074,97
92079,1.30684575808096,103.91574700260743,MARINE PARADE,195415,99427,95988,147421,0.03750758186377477,919
92069,1.30566306799291,103.9110051545323,MARINE PARADE,132666,83617,49049,108141,0.027513769478774854,674
92059,1.304086,103.907533,MARINE PARADE,135919,106939,28980,121429,0.03089456833243776,757
92049,1.302999,103.905955,MARINE PARADE,619391,523646,95745,571518,0.1454084436519955,3565
92241,1.30178441800843,103.9009525469614,MARINE PARADE,148302,67544,80758,107923,0.027458304837737937,673
82081,1.31037284851913,103.89412794527634,GEYLANG,53649,32752,20897,43200,0.002885380465132682,161
82091,1.31264667096781,103.89411050584133,GEYLANG,78371,69383,8988,73877,0.004934334551449239,275
81129,1.31631147367096,103.89217268755989,GEYLANG,144068,672953,-528885,408510,0.02728487902341092,1524
81119,1.31856724602339,103.89169495502705,GEYLANG,349852,110159,239693,230005,0.015362313284325057,858
81229,1.31946112797115,103.89018804743054,GEYLANG,11657,20022,-8365,15839,0.0010579060460008459,59
81219,1.31877141262042,103.8866869928233,GEYLANG,99978,177557,-77579,138767,0.009268416458450621,517
81209,1.31843612461246,103.88429716458627,GEYLANG,47661,52940,-5279,50300,0.003359598087874396,187
54339,1.3678447007404,103.85057966582927,ANG MO KIO,165679,44643,121036,105161,0.006238980955567143,1012
54329,1.36449772525141,103.85247983714417,ANG MO KIO,162503,146885,15618,154694,0.00917766966784743,1489
54319,1.36205969144532,103.85305482306448,ANG MO KIO,169475,122386,47089,145930,0.008657719980277034,1404
70151,1.32768374279565,103.8809633442231,GEYLANG,23702,33892,-10190,28797,0.0019233866031117092,107
70161,1.32758635490072,103.88324806418214,GEYLANG,23895,93692,-69797,58793,0.003926855872373744,219
70171,1.32833666697134,103.88547138902759,GEYLANG,108656,204144,-95488,156400,0.010446145943211839,583
70181,1.32886177068404,103.88691723349123,GEYLANG,202001,153625,48376,177813,0.011876346218672165,663
70191,1.327333,103.887875,GEYLANG,50774,80244,-29470,65509,0.004375425668758723,244
70371,1.32623288866609,103.88932330108935,GEYLANG,120677,71486,49191,96081,0.006417366677555861,358
70259,1.32498730068675,103.89080428753108,GEYLANG,95370,99640,-4270,97505,0.006512477366962087,363
81101,1.32111522416649,103.89152220076973,GEYLANG,18424,40799,-22375,29611,0.0019777546516908297,110
92301,1.30793535291547,103.9126288890594,BEDOK,21648,17571,4077,19609,0.0007985648394210277,107
93101,1.31261779524488,103.91989561129017,BEDOK,6767,3929,2838,5348,0.00021779411296974125,29
83171,1.3147363890036,103.91900527803291,BEDOK,13183,9282,3901,11232,0.00045741650652134135,61
83181,1.31662343088137,103.91755342481619,BEDOK,10920,6624,4296,8772,0.00035723447250758607,47
83191,1.31729916899357,103.91597628595028,BEDOK,2800,2758,42,2779,0.00011317311891228701,15
83201,1.31860774070821,103.91440987586641,BEDOK,1216,11910,-10694,6563,0.0002672742639155594,35
83321,1.32168778524368,103.9136543376456,BEDOK,106588,104702,1886,105645,0.0043023296680419435,577
83329,1.32198642679896,103.91379833222052,BEDOK,65563,59901,5662,62732,0.002554723316158902,342
83209,1.31870305598811,103.91459583301028,BEDOK,12408,1280,11128,6844,0.00027871782145940706,37
83199,1.31733638898862,103.91628277801507,BEDOK,1540,3101,-1561,2320,9.44806174438668e-05,12
83189,1.31683972198045,103.91749277802164,BEDOK,6332,8014,-1682,7173,0.00029211615039864507,39
83179,1.31460443311119,103.91922466611177,BEDOK,10200,22776,-12576,16488,0.0006714639743165844,90
93109,1.31278666699062,103.91998638901408,BEDOK,2038,6634,-4596,4336,0.00017658101605026142,23
92309,1.30827858622776,103.91268253327297,BEDOK,13365,25456,-12091,19410,0.0007904606830109719,106
81109,1.3209137166719,103.89117183414866,GEYLANG,52374,23879,28495,38126,0.002546481842908533,142
70251,1.32497158481981,103.89037074589527,GEYLANG,97096,102484,-5388,99790,0.006665095292027553,372
70379,1.32604294133609,103.88933975894,GEYLANG,15981,35042,-19061,25511,0.0017039106723611074,95
70201,1.32461138902969,103.88885416699938,GEYLANG,54540,60944,-6404,57742,0.0038566583059650764,215
70211,1.32362166702646,103.88696166698931,GEYLANG,178906,179100,-194,179003,0.011955827763892255,667
70221,1.32620809233247,103.88512100988676,GEYLANG,203048,115091,87957,159069,0.01062441169463404,593
70231,1.325842,103.884002,GEYLANG,133447,33527,99920,83487,0.00557619812251232,311
70241,1.32525399997752,103.88199999996775,GEYLANG,39357,30746,8611,35051,0.002341098858411241,130
54311,1.36143610819625,103.85257506359629,ANG MO KIO,143702,188745,-45043,166223,0.00986166099007462,1600
54321,1.3639846735447,103.85237785571755,ANG MO KIO,116642,112023,4619,114332,0.006783077097135845,1100
54331,1.36719473720813,103.85056845375878,ANG MO KIO,46090,71658,-25568,58874,0.003492870596305284,566
66111,1.35848277799301,103.86823666699911,SERANGOON,6892,33996,-27104,20444,0.002076145510543517,242
66121,1.36239972197855,103.86776000002241,SERANGOON,3075,29345,-26270,16210,0.0016461709413965176,192
66271,1.36398333300081,103.86578916701893,SERANGOON,283086,297092,-14006,290089,0.029459351154767083,3443
66131,1.36346698150382,103.87019205208469,SERANGOON,16789,15846,943,16317,0.0016570370913489808,193
66141,1.36311828855893,103.87239656838271,SERANGOON,12179,6353,5826,9266,0.0009409882753226485,110
63169,1.35703664863271,103.87567788589342,HOUGANG,6524,4085,2439,5304,0.00027890397468662476,63
63159,1.35516666700323,103.87701916697013,HOUGANG,9176,8454,722,8815,0.00046352536517017297,105
65061,1.39490129020977,103.9018594759131,SENGKANG,401766,283856,117910,342811,0.026493190780634533,3244
65071,1.39845074063981,103.90416383740006,PUNGGOL,76797,118257,-41460,97527,0.013254630327412895,2312
65151,1.39885650320272,103.90662105241732,PUNGGOL,52239,90626,-38387,71432,0.009708129579990751,1693
65241,1.39917246521216,103.90767172209786,PUNGGOL,39085,21519,17566,30302,0.004118262718849811,718
65289,1.40173746082241,103.90762981656073,PUNGGOL,150000,86794,63206,118397,0.016091015481607192,2807
65229,1.40320219454105,103.90556931496221,PUNGGOL,70874,108607,-37733,89740,0.012196320255744903,2127
65221,1.40402842836975,103.90480763848863,PUNGGOL,96372,48597,47775,72484,0.009851104049670309,1718
65281,1.40201165055481,103.90783309940194,PUNGGOL,91679,115590,-23911,103634,0.014084616150923416,2457
65249,1.39963747797366,103.90824975943016,PUNGGOL,23610,42411,-18801,33010,0.0044862996617131634,782
65159,1.39856872266182,103.90665292741664,PUNGGOL,54809,33571,21238,44190,0.006005743170284903,1047
65079,1.398951,103.904753,PUNGGOL,77686,39509,38177,58597,0.007963759505525787,1389
65069,1.39504382175966,103.90236824858533,SENGKANG,319078,384615,-65537,351846,0.02719143552395675,3330
65059,1.39269,103.901269,SENGKANG,68886,33537,35349,51211,0.003957699120118885,484
63151,1.35412291412202,103.87758355854012,HOUGANG,10120,19732,-9612,14926,0.0007848643903040274,178
63161,1.35717307747832,103.87530650239555,SERANGOON,4958,9899,-4941,7428,0.0007543342228681884,88
66149,1.36291833299844,103.87236222198605,SERANGOON,9153,16927,-7774,13040,0.0013242485549543855,154
66139,1.36357778856307,103.86929111065648,SERANGOON,7419,12369,-4950,9894,0.0010047634357913107,117
66129,1.361491111,103.8680175,SERANGOON,23901,3872,20029,13886,0.0014101622265411502,164
66119,1.35683000003038,103.86812666696963,SERANGOON,23576,7472,16104,15524,0.0015765057183368006,184
71161,1.32732994325917,103.89209147524538,GEYLANG,82195,78885,3310,80540,0.005379364413467273,300
71229,1.32623562632795,103.8933485973626,GEYLANG,8073,14819,-6746,11446,0.0007644922408312193,42
71219,1.32554207103,103.89505220634288,GEYLANG,27880,40009,-12129,33944,0.0022671609839922165,126
71209,1.32608112825105,103.89720788120638,GEYLANG,32042,47340,-15298,39691,0.002651010093555122,148
71119,1.32680124825187,103.90021869264116,GEYLANG,63500,95111,-31611,79305,0.005296877263596003,295
71109,1.32831828375817,103.90256616022272,GEYLANG,35083,58717,-23634,46900,0.0031325079586741384,174
71129,1.329761944,103.8991489,GEYLANG,46966,66611,-19645,56788,0.0037929394873600633,211
70409,1.33094654621155,103.89789906902672,GEYLANG,4364,1947,2417,3155,0.0002107262816549447,11
70071,1.33377161253401,103.89841293744438,GEYLANG,16781,14021,2760,15401,0.0010286514940626953,57
71331,1.33683480070641,103.90096749998749,BEDOK,3280,5394,-2114,4337,0.00017662174045433203,23
71291,1.33709007875103,103.90374749997088,BEDOK,11115,20411,-9296,15763,0.000641938781365376,86
72131,1.33791126455323,103.90994099232343,BEDOK,4692,5283,-591,4987,0.000203092603100243,27
72141,1.33860729777301,103.91150189998882,BEDOK,3363,2663,700,3013,0.00012270262946481494,16
72151,1.34084789558521,103.91301810001244,BEDOK,13395,9283,4112,11339,0.000461774017756899,61
72161,1.34114935376337,103.916355499978,BEDOK,5257,303,4954,2780,0.00011321384331635764,15
84459,1.336324,103.918288,BEDOK,83597,43780,39817,63688,0.0025936558464504265,348
84539,1.3350342184363,103.91851751540032,BEDOK,212210,46991,165219,129600,0.005277882767553939,708
84361,1.32936638901809,103.92462499999526,BEDOK,94301,221432,-127131,157866,0.006428998773014429,862
84371,1.33055000001009,103.9262383330096,BEDOK,24766,142390,-117624,83578,0.0034036642434153016,456
84401,1.33316500001136,103.9269811109948,BEDOK,78723,76319,2404,77521,0.003156996527959482,423
84411,1.33383806396564,103.92928425024714,BEDOK,91449,52178,39271,71813,0.0029245416295243134,392
84421,1.33232270053889,103.93032045625178,BEDOK,111696,57198,54498,84447,0.0034390537505526813,461
84331,1.32898829919632,103.93099993868753,BEDOK,41584,43915,-2331,42749,0.0017409275496154577,233
84359,1.32787704925987,103.934076210002,BEDOK,235789,60446,175343,148117,0.006031976557729836,809
84199,1.32553283664673,103.9355563841307,BEDOK,37675,39614,-1939,38644,0.0015737538709055124,211
84049,1.32432719820227,103.93471220144858,BEDOK,324818,280598,44220,302708,0.012327602907412945,1654
84039,1.32353645344906,103.92886300203479,BEDOK,471348,854945,-383597,663146,0.02700622566182349,3624
84139,1.32132832560695,103.92782177344944,BEDOK,33618,49648,-16030,41633,0.0016954791146726322,227
84129,1.31875790465263,103.93158674239623,BEDOK,15076,72648,-57572,43862,0.0017862538113460715,239
84121,1.31848306586196,103.93156320282378,BEDOK,58809,21640,37169,40224,0.0016380984293371114,219
84131,1.3214133317439,103.92757312069912,BEDOK,24528,37453,-12925,30990,0.0012620492821488931,169
84031,1.32428292329305,103.93003627080394,BEDOK,1187665,968303,219362,1077984,0.04390025599767643,5891
84041,1.3246905167586,103.93468799273933,BEDOK,181267,189925,-8658,185596,0.007558286497893062,1014
84191,1.32566318975139,103.93533757051014,BEDOK,61454,42437,19017,51945,0.002115429169448992,283
84351,1.32766562447954,103.93409675152876,BEDOK,94484,293365,-198881,193924,0.007897439334993287,1059
84339,1.32874469952532,103.93079062255664,BEDOK,43186,25843,17343,34514,0.0014055620820938013,188
84429,1.33222526253562,103.93014326693238,BEDOK,17229,20897,-3668,19063,0.0007763293147984624,104
84419,1.33361648978155,103.9292288767243,BEDOK,51880,87119,-35239,69499,0.0028303053585048703,379
84409,1.33291002440884,103.92669166477268,BEDOK,87325,79231,8094,83278,0.003391446922194112,455
84379,1.33041495636834,103.92645503858006,BEDOK,135717,31734,103983,83725,0.0034096507308136845,457
84369,1.329162,103.924608,BEDOK,214973,69981,144992,142477,0.00580229091877147,778
84451,1.335644,103.918055,BEDOK,96565,318159,-221594,207362,0.008444693876894444,1133
72169,1.34105,103.916208,BEDOK,1042,7883,-6841,4462,0.00018171229096316106,24
72159,1.340359,103.912709,BEDOK,9278,15244,-5966,12261,0.0004993219183100219,67
72149,1.33834674682355,103.91170534393189,BEDOK,2893,3515,-622,3204,0.00013048099064230572,17
72139,1.337282,103.909145,BEDOK,4291,7707,-3416,5999,0.00024430570001972285,32
71299,1.33675693078428,103.9040176205713,BEDOK,22891,12490,10401,17690,0.0007204147080094844,96
71339,1.33681468016557,103.90112122053516,BEDOK,5089,3322,1767,4205,0.00017124611911700858,22
70079,1.33372166698373,103.89851833301576,GEYLANG,13559,17993,-4434,15776,0.001053698199489194,58
70401,1.33088230075978,103.89811560002391,GEYLANG,1890,3835,-1945,2862,0.00019115645581504017,10
71121,1.330081111,103.8994169,GEYLANG,66406,62634,3772,64520,0.004309369157647237,240
71101,1.3283069439771,103.90283722202501,GEYLANG,63812,26030,37782,44921,0.0030003281452366942,167
71111,1.3267052749653,103.90058695177659,GEYLANG,107682,101062,6620,104372,0.0069711326367321354,389
71201,1.32612447781531,103.89795152582765,GEYLANG,51740,42897,8843,47318,0.0031604266863228757,176
71211,1.32546235545492,103.89525403753592,GEYLANG,45054,31414,13640,38234,0.002553695294071365,142
71221,1.32632177179998,103.89318347862555,GEYLANG,9502,9564,-62,9533,0.0006367206475488392,35
71169,1.32706502989935,103.89217317535862,GEYLANG,76533,134247,-57714,105390,0.007039126093063271,393
81231,1.31389305598354,103.88189611100506,GEYLANG,4046,14522,-10476,9284,0.000620089635145644,34
54247,1.36873836498602,103.84719306132868,ANG MO KIO,109605,52483,57122,81044,0.004808170068399726,780
54469,1.3772016702489,103.84349683756662,ANG MO KIO,7470,10267,-2797,8868,0.0005261197888377766,85
54459,1.37693336122245,103.84120098441312,ANG MO KIO,16019,52821,-36802,34420,0.0020420662079156824,331
55111,1.37695556267127,103.83777368753996,ANG MO KIO,17892,79343,-61451,48617,0.002884344358809899,468
55121,1.37943138901774,103.83519777802985,ANG MO KIO,19116,59456,-40340,39286,0.0023307557537529198,378
56209,1.38031863295854,103.83240305645302,ANG MO KIO,22465,38595,-16130,30530,0.0018112806893569372,293
56199,1.37892333298882,103.83003638899949,ANG MO KIO,8330,15922,-7592,12126,0.0007194100766178258,116
56041,1.379094,103.827593,ANG MO KIO,7746,20585,-12839,14165,0.0008403796581965613,136
56051,1.38249472962714,103.82576395474278,ANG MO KIO,66158,95035,-28877,80596,0.004781591170632549,775
56061,1.385195,103.82284,ANG MO KIO,4804,2353,2451,3578,0.00021227521475660404,34
56071,1.38717744383548,103.81964816646843,ANG MO KIO,537,442,95,489,2.9011341536047897e-05,4
56081,1.391697,103.818205,CENTRAL WATER CATCHMENT,762,700,62,731,0.0015656491018400125,0
56091,1.3962,103.818459,YISHUN,105507,63049,42458,84278,0.004226615137649347,936
57011,1.40015725353057,103.81717214668784,YISHUN,9738,5723,4015,7730,0.0003876662357202289,85
57149,1.40236816337763,103.81689548453724,YISHUN,2541,2267,274,2404,0.00012056269478284999,26
48109,1.40220535791866,103.81401491687515,YISHUN,434,3802,-3368,2118,0.00010621954556991526,23
48099,1.4029276207034,103.81200115976088,YISHUN,249,1788,-1539,1018,5.1053587058627826e-05,11
48089,1.40560991243809,103.80795339830527,CENTRAL WATER CATCHMENT,303,1868,-1565,1085,0.0023238430581346285,0
48079,1.41314885322808,103.805294456727,CENTRAL WATER CATCHMENT,669,5611,-4942,3140,0.006725223228149986,0
48069,1.41601156056508,103.80203473964005,CENTRAL WATER CATCHMENT,6995,16011,-9016,11503,0.024637019997901046,0
48059,1.41502109155627,103.79763214717948,CENTRAL WATER CATCHMENT,4784,5327,-543,5055,0.01082675268098668,0
48049,1.41239185628293,103.78930383598242,CENTRAL WATER CATCHMENT,1030,683,347,856,0.0018333729564638176,0
48039,1.41075606597918,103.78320916874394,CENTRAL WATER CATCHMENT,843,1577,-734,1210,0.002591566912758434,0
48029,1.41056509187543,103.77968553987141,CENTRAL WATER CATCHMENT,6149,7492,-1343,6820,0.01460701350827481,0
48111,1.40944188012509,103.77966346202638,CENTRAL WATER CATCHMENT,5013,22654,-17641,13833,0.029627392648088773,0
48131,1.40462388269986,103.78935694475769,CENTRAL WATER CATCHMENT,86007,81170,4837,83588,0.179028012482357,0
48119,1.410027,103.778718,CENTRAL WATER CATCHMENT,22609,2644,19965,12626,0.027042251107841312,0
48021,1.41091935719422,103.7794566466511,MANDAI,14769,11814,2955,13291,0.04021835501450959,84
48031,1.41109191008995,103.78316982719807,MANDAI,1006,571,435,788,0.002384475491041574,4
48041,1.41268317529503,103.78892108182363,MANDAI,1018,1017,1,1017,0.0030774258558239603,6
48051,1.41529381857807,103.79737495337397,MANDAI,19088,6630,12458,12859,0.038911129872212694,81
48061,1.41583154711836,103.80385151827096,MANDAI,1536,943,593,1239,0.003749194331726536,7
48071,1.41176331480418,103.80578610823426,CENTRAL WATER CATCHMENT,9465,242,9223,4853,0.010394110931914611,0
48081,1.40542137548827,103.80892543786545,CENTRAL WATER CATCHMENT,1827,380,1447,1103,0.0023623952932004567,0
48091,1.40274777797647,103.81238027797018,YISHUN,1853,333,1520,1093,5.481490241167015e-05,12
48101,1.40241038608699,103.81439973574913,YISHUN,3591,541,3050,2066,0.00010361170025847258,22
57141,1.40248255094729,103.8169622653191,YISHUN,1949,2687,-738,2318,0.00011624971984469479,25
57019,1.40056260892652,103.81734465881833,YISHUN,8454,15169,-6715,11811,0.0005923319417971053,131
56099,1.39606817759915,103.8188299218487,YISHUN,69460,114256,-44796,91858,0.004606758742663491,1020
56089,1.39205091187219,103.81861107436661,ANG MO KIO,697,520,177,608,3.6071361255454235e-05,5
56079,1.38756640996273,103.81959791299872,ANG MO KIO,208,612,-404,410,2.4324437688710917e-05,3
56069,1.38530499508514,103.82320879865532,ANG MO KIO,3539,9954,-6415,6746,0.0004002259918244972,64
56059,1.38268805765919,103.82604547355085,ANG MO KIO,94453,78282,16171,86367,0.005123972463075355,831
56049,1.37945638898658,103.82768833298778,ANG MO KIO,26176,7898,18278,17037,0.0010107693778111412,164
56191,1.37879833302094,103.82944083302411,ANG MO KIO,27119,27324,-205,27221,0.0016149646788399996,262
56201,1.38059381566563,103.83224759401025,ANG MO KIO,27419,16302,11117,21860,0.001296907824085904,210
55129,1.37955302001994,103.83549938754196,ANG MO KIO,102633,66794,35839,84713,0.005025844121765288,815
55119,1.37728530731209,103.8378470631113,ANG MO KIO,116293,35597,80696,75945,0.004505657122607684,731
54451,1.37723501808517,103.84059645206445,ANG MO KIO,62942,62228,714,62585,0.0037130364213365185,602
54461,1.37747997146347,103.84339938777067,ANG MO KIO,48802,31416,17386,40109,0.0023795826128207467,386
52009,1.33202083385749,103.84692763524869,TOA PAYOH,3167270,2939658,227612,3053464,0.23044018254005808,28079
50331,1.31862919267946,103.85727882383885,KALLANG,49736,18025,31711,33880,0.003440642518664064,176
50349,1.31930481783402,103.85957694494822,KALLANG,45680,36342,9338,41011,0.004164822619035771,213
07517,1.30145216158073,103.85247781934106,ROCHOR,99936,121034,-21098,110485,0.028501504722605302,186
04029,1.29948166696821,103.85092666701239,ROCHOR,46018,22535,23483,34276,0.008842083322369729,57
13109,1.29350944398488,103.84272416702719,MUSEUM,78783,49391,29392,64087,0.03376986621574838,17
13099,1.29578024244395,103.83961272081199,RIVER VALLEY,94781,113777,-18996,104279,0.09925019130686383,540
13089,1.29575111096804,103.83604111103381,RIVER VALLEY,60303,56183,4120,58243,0.055434257063125554,302
13079,1.29612213279141,103.83229211134126,SINGAPORE RIVER,26494,36501,-10007,31497,0.023930835577221143,41
13069,1.29488000002792,103.82880805602646,TANGLIN,48970,99193,-50223,74081,0.03707926637299296,374
13059,1.29328273601932,103.82663492676832,TANGLIN,68683,125124,-56441,96903,0.04850220905957178,489
10519,1.291728,103.826122,BUKIT MERAH,54805,62083,-7278,58444,0.003405870575402964,515
10219,1.29089526651849,103.81191424883255,BUKIT MERAH,2537,3559,-1022,3048,0.0001776246238078885,26
10421,1.2889706156154,103.81503540991777,BUKIT MERAH,41251,32615,8636,36933,0.0021522999445855464,325
10431,1.28708384358883,103.81399869917512,BUKIT MERAH,15233,14439,794,14836,0.0008645796977735674,130
10441,1.28656898930199,103.8116061687213,BUKIT MERAH,3619,15245,-11626,9432,0.0005496573004448832,83
10449,1.28666552495266,103.81195378046979,BUKIT MERAH,11184,14636,-3452,12910,0.0007523405161941733,113
10439,1.28747956947939,103.81418936580334,BUKIT MERAH,11103,23898,-12795,17500,0.0010198264162198322,154
10429,1.2892779060127,103.81404805422201,BUKIT MERAH,15103,41922,-26819,28512,0.001661559473100563,251
10211,1.29075499997303,103.81144166700754,BUKIT MERAH,4966,2558,2408,3762,0.00021923354158965764,33
13051,1.29334305906356,103.8263656209055,TANGLIN,156008,80383,75625,118195,0.0591593511015767,597
13062,1.29476674399435,103.82853268161283,TANGLIN,43662,21378,22284,32520,0.016277017621923722,164
13071,1.29636199316259,103.8322512944371,RIVER VALLEY,43983,33040,10943,38511,0.0366538240433705,199
13081,1.2959113890106,103.83624277798825,RIVER VALLEY,58072,62978,-4906,60525,0.05760620862156266,313
13091,1.29593138900491,103.83937805601917,RIVER VALLEY,107432,102543,4889,104987,0.09992404831973563,544
13101,1.29414162678811,103.84231209757696,RIVER VALLEY,29909,49302,-19393,39605,0.03769506637681932,205
08058,1.2989583431631,103.84654115271174,MUSEUM,84483,91546,-7063,88014,0.04637790823588057,23
84009,1.32453874317344,103.92903818515839,BEDOK,3226685,3105228,121457,3165956,0.12893167141384257,17303
84659,1.327201,103.93063,BEDOK,138769,6640,132129,72704,0.0029608270735512468,397
84211,1.33012,103.93447,BEDOK,193005,131853,61152,162429,0.006614824228788725,887
84221,1.33185798500032,103.93512740972372,BEDOK,185819,96334,89485,141076,0.0057452360286685145,771
84231,1.33173871602405,103.93855496527853,BEDOK,305778,271015,34763,288396,0.011744755236354057,1576
84241,1.32861392886029,103.94004872476815,BEDOK,117924,82211,35713,100067,0.004075168942135957,546
84281,1.32657714220068,103.9403951168328,BEDOK,53742,46550,7192,50146,0.0020421659665259247,274
84061,1.32584790501258,103.94223128727671,BEDOK,223029,215533,7496,219281,0.008930088049012309,1198
13199,1.302127,103.829875,RIVER VALLEY,64481,44309,20172,54395,0.05177182516265842,282
13159,1.29796011528522,103.83053183555204,RIVER VALLEY,30613,53595,-22982,42104,0.040073553206150754,218
10091,1.28394108576437,103.81783962251122,BUKIT MERAH,183156,230328,-47172,206742,0.01204805445383546,1822
18041,1.28836025261771,103.7931740283919,QUEENSTOWN,15198,21763,-6565,18480,0.001604850957283175,153
18131,1.28950073498414,103.7918327963467,QUEENSTOWN,31272,19853,11419,25562,0.002219870139073188,212
18101,1.292825,103.786354,QUEENSTOWN,38432,34443,3989,36437,0.0031642832429938875,303
18121,1.29751168042934,103.7854209482613,QUEENSTOWN,15914,47568,-31654,31741,0.0027564704672686825,264
18141,1.30418279677397,103.78788091438994,QUEENSTOWN,85093,49390,35703,67241,0.00583938220880292,560
11361,1.30649698638726,103.79058123542397,QUEENSTOWN,243002,573814,-330812,408408,0.035467206155958164,3402
17009,1.31491572870629,103.76412225438476,CLEMENTI,1712778,882217,830561,1297497,0.12079341206568384,5270
17239,1.312440556,103.7658489,CLEMENTI,433468,13180,420288,223324,0.020790851891107864,907
11369,1.3063259638605,103.79084827741467,QUEENSTOWN,377900,203723,174177,290811,0.02525477877372713,2422
18149,1.30253001117245,103.78724143833315,QUEENSTOWN,30844,41567,-10723,36205,0.0031441357634435793,301
18129,1.29776225378985,103.78570767644749,QUEENSTOWN,55575,32290,23285,43932,0.0038151684120868203,365
18109,1.29403436577434,103.78672599789039,QUEENSTOWN,25985,36859,-10874,31422,0.0027287676828870087,261
18049,1.29018147748939,103.79208093037771,QUEENSTOWN,37031,26999,10032,32015,0.0027802653353582707,266
10109,1.28535315729277,103.81370529674271,BUKIT MERAH,68623,49469,19154,59046,0.003440952604120926,520
10099,1.28420923932422,103.81765723225827,BUKIT MERAH,159479,122620,36859,141049,0.008219742638936635,1243
13063,1.29534692836828,103.82964309110659,TANGLIN,33767,18393,15374,26080,0.013053647588553832,131
13141,1.29763682834545,103.82997986347917,TANGLIN,64787,33657,31130,49222,0.024636757730206932,248
13191,1.302461,103.8297819,RIVER VALLEY,48573,85919,-37346,67246,0.06400309136663532,348
84069,1.32548742810424,103.94219019887281,BEDOK,220403,275969,-55566,248186,0.010107226948673933,1356
84289,1.32663077053638,103.94017072989195,BEDOK,45578,49663,-4085,47620,0.0019392961218435074,260
84249,1.32941668893627,103.93960622332179,BEDOK,117402,154190,-36788,135796,0.0055302111751755765,742
84239,1.33151836127292,103.9383568845181,BEDOK,150025,175929,-25904,162977,0.006637141202219431,890
84229,1.3315995317556,103.93531396427683,BEDOK,94596,132247,-37651,113421,0.00461900263409518,619
84219,1.32940888887166,103.9348130555732,BEDOK,167069,206703,-39634,186886,0.007610820979144177,1021
84651,1.327057,103.930691,BEDOK,9286,232263,-222977,120774,0.004918449177226538,660
80101,1.31251933500742,103.87153830811837,KALLANG,399674,189682,209992,294678,0.029925668716496136,1533
80319,1.31484297001272,103.87262229395158,KALLANG,60270,20835,39435,40552,0.004118209427888581,211
80309,1.31723134728621,103.87298911852837,KALLANG,7360,5656,1704,6508,0.0006609120871152812,33
80299,1.31954835158003,103.87197222899434,KALLANG,3056,11558,-8502,7307,0.0007420535680011309,38
60191,1.31718305596849,103.86195722198198,KALLANG,28154,51350,-23196,39752,0.004036966393209382,206
60241,1.32355461431031,103.8615915962133,KALLANG,16837,57300,-40463,37068,0.0037643960118606706,192
60251,1.32450918973195,103.86155521539519,KALLANG,21523,42183,-20660,31853,0.0032347929795456445,165
60249,1.32346800000844,103.86194240512685,KALLANG,27957,7900,20057,17928,0.0018206564071608423,93
80291,1.3195596877041,103.87229334189442,KALLANG,8955,7555,1400,8255,0.0008383265640959813,42
80301,1.31643329020681,103.87348616263843,KALLANG,4544,13207,-8663,8875,0.0009012899159723603,46
80311,1.31443333298525,103.87260027800174,KALLANG,1211,36272,-35061,18741,0.001903219641153578,97
80109,1.31324473748019,103.871430158598,KALLANG,71536,323069,-251533,197302,0.020036766535344072,1027
50051,1.325878056,103.8418119,NOVENA,59613,74983,-15370,67298,0.011624789693877199,573
52241,1.33804611111505,103.8389949999753,TOA PAYOH,10973,10547,426,10760,0.0008120404773499949,98
52211,1.338573,103.84164,TOA PAYOH,22562,8990,13572,15776,0.0011905902017354574,145
52159,1.33810803464351,103.84385638188928,TOA PAYOH,80271,57645,22626,68958,0.0052041530889499026,634
52149,1.33640498933489,103.84357399610558,TOA PAYOH,60417,43339,17078,51878,0.003915152033825561,477
52139,1.33271833297864,103.84404416701967,TOA PAYOH,62601,72703,-10102,67652,0.005105591298669318,622
52131,1.33220703637711,103.84419754508008,TOA PAYOH,96298,110950,-14652,103624,0.007820342232798873,952
52141,1.33627740506187,103.84333464003154,TOA PAYOH,11867,26509,-14642,19188,0.001448088538976924,176
52151,1.33834001400213,103.84365712218609,TOA PAYOH,75230,93633,-18403,84431,0.006371876351592697,776
52219,1.338366,103.841761,TOA PAYOH,6016,40188,-34172,23102,0.0017434720360352772,212
52249,1.33782999993927,103.8386000000533,TOA PAYOH,8025,10279,-2254,9152,0.000690687216422598,84
50279,1.31251000009337,103.8526780549204,KALLANG,13160,39462,-26302,26311,0.0026719818568054954,136
50259,1.31236388897416,103.85507888893754,ROCHOR,5675,33990,-28315,19832,0.0051160052645943645,33
07249,1.315368056,103.8594669,KALLANG,27562,32120,-4558,29841,0.00303046674732746,155
52509,1.33115712303762,103.85017633434691,TOA PAYOH,325745,112043,213702,218894,0.01651958998597117,2012
52329,1.33146817532374,103.85268688199498,TOA PAYOH,133041,46194,86847,89617,0.0067632557117727225,824
52081,1.33081389290944,103.8608407974236,TOA PAYOH,195329,153361,41968,174345,0.013157546191782981,1603
60081,1.32931226062177,103.8662910461625,TOA PAYOH,126210,167739,-41529,146974,0.011091899360412468,1351
61061,1.33268166698419,103.8682283329788,TOA PAYOH,38276,19318,18958,28797,0.002173264835153142,264
61009,1.33521166697553,103.86663249997784,TOA PAYOH,15710,36696,-20986,26203,0.0019774996866172784,240
61079,1.33598640879377,103.86525430193133,TOA PAYOH,14386,16732,-2346,15559,0.0011742135489859267,143
61101,1.33560138948489,103.86370334032118,TOA PAYOH,177999,192695,-14696,185347,0.013987850033028765,1704
61089,1.3330716590648,103.86530804883829,TOA PAYOH,28451,14718,13733,21584,0.0016289109352344137,198
61099,1.33236805597247,103.86709999996721,TOA PAYOH,36001,31620,4381,33810,0.002551588154201053,310
61069,1.33275975641149,103.86838092392759,TOA PAYOH,21854,6480,15374,14167,0.00106916147236221,130
60089,1.32865054961465,103.86615967295366,KALLANG,232515,198823,33692,215669,0.021902005057785123,1122
52089,1.32991690265608,103.86027368842302,NOVENA,133032,154271,-21239,143651,0.024813704186085077,1224
52321,1.3312589884768,103.8527071071997,TOA PAYOH,73214,184410,-111196,128812,0.009721241446878024,1184
52501,1.33090220918791,103.85011762889827,TOA PAYOH,65590,207593,-142003,136591,0.010308310487148063,1256
50037,1.32109968376279,103.84224304873378,NOVENA,46115,80735,-34620,63425,0.010955783029720962,540
06189,1.28779136477868,103.84329428089559,OUTRAM,29657,45598,-15941,37627,0.012031392190706536,109
17011,1.29386900823232,103.76688187253777,CLEMENTI,22342,15369,6973,18855,0.0017553487865470739,76
17021,1.29673702633957,103.76691201794645,CLEMENTI,43658,42107,1551,42882,0.003992196587892422,174
17381,1.29907638900012,103.76686444402534,CLEMENTI,17460,15484,1976,16472,0.0015334980223815117,66
17031,1.30172305827699,103.76567633935802,CLEMENTI,68819,45294,23525,57056,0.005311757112979573,231
17041,1.3042101570614,103.76455953939507,CLEMENTI,517696,249058,268638,383377,0.035691347215065373,1557
17061,1.30775834752765,103.76180505768346,CLEMENTI,60691,253865,-193174,157278,0.014642150434927111,638
17071,1.30891781912545,103.76044433406533,CLEMENTI,30849,146544,-115695,88696,0.008257354334212636,360
20291,1.31095062259154,103.75771430804498,CLEMENTI,91537,106883,-15346,99210,0.009236178897551588,402
20281,1.31234219524906,103.75484214400765,CLEMENTI,61886,79524,-17638,70705,0.006582441577979892,287
20131,1.3155936163792,103.7518511517015,CLEMENTI,41681,21104,20577,31392,0.0029225091014206178,127
20141,1.31771999750607,103.7487710528033,JURONG EAST,16445,19209,-2764,17827,0.001738600231273719,136
20199,1.31908111097886,103.74819972197395,JURONG EAST,77140,73549,3591,75344,0.007348016818594665,577
20189,1.32030501410074,103.74727299945995,JURONG EAST,68522,34013,34509,51267,0.0049998776045722644,392
20259,1.31962187605788,103.74477002532701,JURONG EAST,43762,67593,-23831,55677,0.0054299683107997335,426
20161,1.31915476642967,103.74213695526599,JURONG EAST,11475,13091,-1616,12283,0.0011979147720163287,94
20171,1.31967681449311,103.73984434693502,JURONG EAST,10117,17357,-7240,13737,0.001339717920962982,105
20239,1.32246879634748,103.73947011845992,JURONG EAST,275931,171900,104031,223915,0.02183758741154736,1716
20219,1.32205689998871,103.74143326706027,JURONG EAST,55073,42635,12438,48854,0.004764546794112653,374
20209,1.32043333301332,103.7440744439939,JURONG EAST,53120,20159,32961,36639,0.00357326380622863,280
20261,1.3215997308483,103.74546423225033,JURONG EAST,60809,23927,36882,42368,0.0041319916193753815,324
20271,1.32527553308365,103.74550887325397,JURONG EAST,95176,99448,-4272,97312,0.00949047319827835,745
28221,1.32761805004,103.74494173101616,JURONG EAST,10840,22216,-11376,16528,0.001611913649099233,126
28231,1.32986201071411,103.74248183726264,JURONG EAST,5825,11140,-5315,8482,0.0008272175442678905,65
28241,1.33175858461326,103.73957485927775,JURONG EAST,55110,75636,-20526,65373,0.006375582707076728,501
28439,1.33451434015094,103.7385749816785,JURONG EAST,55564,152853,-97289,104208,0.010163014130283934,798
28301,1.33473899929823,103.74030301599491,JURONG EAST,550084,167029,383055,358556,0.03496861751974979,2748
28431,1.33449626498358,103.73881557585635,JURONG EAST,199785,67267,132518,133526,0.01302228835368007,1023
28249,1.332605,103.739045,JURONG EAST,162665,120311,42354,141488,0.01379879225458327,1084
28239,1.32980442518564,103.74307145172916,JURONG EAST,52183,38088,14095,45135,0.004401846717817878,345
28229,1.32536675242565,103.74593185918442,JURONG EAST,57932,65053,-7121,61492,0.005997083380349107,471
20269,1.32151780618055,103.74580944947768,JURONG EAST,49714,66083,-16369,57898,0.005646574083709305,443
20201,1.32127611097845,103.74340527799251,JURONG EAST,76616,118811,-42195,97713,0.009529581219411505,749
20211,1.32177193921987,103.74184000241928,JURONG EAST,30391,43842,-13451,37116,0.0036197838213920096,284
20231,1.32234407286907,103.7394439595661,JURONG EAST,125805,228732,-102927,177268,0.017288281023022923,1358
20179,1.32000211967899,103.73910069465363,JURONG EAST,42782,23704,19078,33243,0.0032420647045623067,254
20169,1.31928347830225,103.74251246450982,JURONG EAST,23805,18501,5304,21153,0.002062972496333257,162
20181,1.32048478912567,103.74745845796298,JURONG EAST,18257,38337,-20080,28297,0.00275969993517431,216
20191,1.31924166701026,103.74845638901051,JURONG EAST,33621,32240,1381,32930,0.0032115389923062527,252
20149,1.31795969674094,103.74897266925451,JURONG EAST,34650,19780,14870,27215,0.0026541765464808582,208
20139,1.31584166892255,103.75204376675156,CLEMENTI,26288,54057,-27769,40172,0.003739903020587062,163
20289,1.31248801817062,103.75503415636196,CLEMENTI,12231,39179,-26948,25705,0.002393064999108594,104
20299,1.3109280417106,103.75857544044081,CLEMENTI,162834,114445,48389,138639,0.01290691065595862,563
17079,1.30968304242083,103.75999360222924,CLEMENTI,143539,27081,116458,85310,0.007942127020966899,346
17069,1.3077663717505,103.76214066046377,CLEMENTI,224719,54948,169771,139833,0.013018068781184671,567
17049,1.30470638200942,103.76459821893782,CLEMENTI,179774,360945,-181171,270359,0.025169681388601452,1098
17039,1.3015316464856,103.76606427132043,CLEMENTI,46056,49721,-3665,47888,0.004458241457977527,194
17389,1.29908138901268,103.76700194402241,CLEMENTI,17354,21565,-4211,19459,0.0018115795299612576,79
17029,1.29694570097768,103.76710295331488,CLEMENTI,31861,43135,-11274,37498,0.0034909609545447987,152
17019,1.2937974792702,103.76705176995323,CLEMENTI,16593,30472,-13879,23532,0.0021907646589777643,95
06171,1.286101944,103.8425356,OUTRAM,214780,99132,115648,156956,0.05018734399990791,458
20159,1.31851137522994,103.74640166581365,JURONG EAST,40717,51029,-10312,45873,0.004473821080900842,351
01329,1.30495670239172,103.86363028484124,KALLANG,242547,237293,5254,239920,0.024364786100291684,1248
01229,1.30337552638813,103.85963089198265,ROCHOR,94219,77537,16682,85878,0.022153706137194175,144
01139,1.30033057855542,103.85716080665901,DOWNTOWN CORE,80457,116149,-35692,98303,0.02047721068490326,32
01039,1.29820784139683,103.85549139837407,DOWNTOWN CORE,153492,152642,850,153067,0.03188493950241688,50
01029,1.2966729849642,103.85441422464267,DOWNTOWN CORE,100229,73238,26991,86733,0.018067097792882354,28
05199,1.28451455846092,103.84666049314171,OUTRAM,74427,77194,-2767,75810,0.024240567730019997,221
05269,1.280894,103.844567,DOWNTOWN CORE,44685,64991,-20306,54838,0.011423143541282817,18
05429,1.27769413050075,103.84370654372525,OUTRAM,12769,44515,-31746,28642,0.009158400487049634,83
05419,1.27470669455555,103.84318683838887,OUTRAM,61692,62048,-356,61870,0.019783193845882303,180
05431,1.27408,103.8420461,DOWNTOWN CORE,4503,16441,-11938,10472,0.0021813917204185724,3
14241,1.27914353103301,103.8168725087535,BUKIT MERAH,117876,173160,-55284,145518,0.008480177167741573,1282
10331,1.28136306628839,103.81834423228645,BUKIT MERAH,26317,50127,-23810,38222,0.0022274174446145385,336
11389,1.30906501014268,103.7929321687807,QUEENSTOWN,19,188923,-188904,94471,0.008204105778436083,787
11379,1.30917002463976,103.79236323128613,QUEENSTOWN,12376,1138,11238,6757,0.000586795341902728,56
10339,1.28115835063292,103.81857250844851,BUKIT MERAH,61083,73738,-12655,67410,0.003928371355278793,594
14249,1.279267,103.8173,BUKIT MERAH,128933,110128,18805,119530,0.006965705801757516,1053
05651,1.273218611,103.8430731,DOWNTOWN CORE,16580,6202,10378,11391,0.002372825925065695,3
05411,1.27519165673078,103.84309190393883,OUTRAM,103823,49705,54118,76764,0.02454561325982397,224
05421,1.27777470568529,103.84346347289251,OUTRAM,28613,8077,20536,18345,0.005865891241356244,53
05271,1.27975329525167,103.84382212419122,OUTRAM,30801,21924,8877,26362,0.008429360856071589,76
05241,1.28071988238536,103.84227488654868,OUTRAM,30730,31273,-543,31001,0.00991270070173262,90
07241,1.31557142083242,103.85900616698896,KALLANG,7302,9315,-2013,8308,0.0008437089151434782,43
64369,1.376302,103.891097,HOUGANG,75280,56849,18431,66064,0.003473889929053013,790
66371,1.353767301605,103.87268543240587,SERANGOON,281691,250116,31575,265903,0.027003195054297238,3156
64361,1.37634509209583,103.89054894445846,HOUGANG,96325,110983,-14658,103654,0.005450511423862633,1240
77139,1.37518089319612,103.94649798163485,PASIR RIS,30724,7044,23680,18884,0.0017806380971877253,129
77381,1.370821,103.94712,PASIR RIS,26574,3939,22635,15256,0.0014385413477386113,104
84481,1.33753167256033,103.91532871743395,BEDOK,148223,182495,-34272,165359,0.006734146732715677,903
84701,1.33601304352046,103.91214210205735,BEDOK,109411,111380,-1969,110395,0.004495770587377447,603
72031,1.33521859078695,103.9099203114682,BEDOK,59560,129765,-70205,94662,0.0038550535381341893,517
72041,1.33470286981513,103.90743417265202,BEDOK,125010,66210,58800,95610,0.003893660273193149,522
72051,1.33343973211343,103.90412516288117,BEDOK,78228,69967,8261,74097,0.0030175561684216375,404
71091,1.33073374785934,103.90373154551283,BEDOK,330397,298244,32153,314320,0.012800494687481127,1717
72019,1.32884628389091,103.90546507501655,GEYLANG,271051,145026,126025,208038,0.013895110676047982,776
83119,1.32306974700238,103.90560762847845,BEDOK,141366,186087,-44721,163726,0.006667643780868334,894
83109,1.32135678897249,103.90537221650075,GEYLANG,155991,294072,-138081,225031,0.015030093783547974,839
83151,1.31488002411227,103.90911503893872,BEDOK,32643,62038,-29395,47340,0.0019278932887037304,258
83139,1.31451138900044,103.90997555601626,BEDOK,15509,12482,3027,13995,0.0005699380349684982,76
83129,1.31306365118709,103.91061094817724,BEDOK,16176,42197,-26021,29186,0.0011885824572054726,159
92209,1.31101000002422,103.91147888898843,BEDOK,16701,36152,-19451,26426,0.0010761831019705276,144
92201,1.31117244269722,103.9112378097299,BEDOK,38033,22663,15370,30348,0.0012359042147355474,165
83121,1.31260836391216,103.91063424326731,BEDOK,47095,19713,27382,33404,0.0013603579935753994,182
83159,1.31480354064185,103.90947767042405,BEDOK,46467,33033,13434,39750,0.0016187950618076316,217
83169,1.31428121358171,103.90687033808844,BEDOK,16906,9346,7560,13126,0.0005345485278311188,71
83101,1.32066709057479,103.90489836683336,GEYLANG,521210,338325,182885,429767,0.028704659869413826,1603
83111,1.32346854012914,103.90527311322877,GEYLANG,145086,103295,41791,124190,0.008294800925111753,463
72011,1.32816499999482,103.90548361097667,GEYLANG,178361,266451,-88090,222406,0.014854766845562481,829
71099,1.33022638900189,103.9038336109893,GEYLANG,279692,286192,-6500,282942,0.018898039804758595,1055
72059,1.33375833299433,103.90428000002385,BEDOK,84916,105285,-20369,95100,0.0038728908271171265,519
72049,1.33490332816583,103.90747460787432,BEDOK,51155,64798,-13643,57976,0.002361038050398975,316
72039,1.33546648279458,103.90985114690736,BEDOK,134337,157052,-22715,145694,0.005933301326666694,796
84709,1.33644333039135,103.91242511468805,BEDOK,49102,62203,-13101,55652,0.0022663945353388255,304
84489,1.33804722197723,103.91618833296936,BEDOK,176481,151473,25008,163977,0.006677865606290063,896
77389,1.369597,103.946715,PASIR RIS,2212,41579,-39367,21895,0.0020645557687950246,149
77141,1.37380309020358,103.9452981948771,PASIR RIS,11319,47863,-36544,29591,0.0027902383993794735,202
77131,1.3755835643888,103.94652128223,PASIR RIS,10745,25040,-14295,17892,0.0016870989639315177,122
82009,1.31933717157385,103.90180834139497,GEYLANG,208953,384213,-175260,296583,0.01980913876135292,1106
82221,1.31760511655727,103.89900705591394,GEYLANG,72501,67441,5060,69971,0.004673448067726826,261
64249,1.36809355475239,103.89589220748978,HOUGANG,85966,87161,-1195,86563,0.004551803310859408,1035
63071,1.3597807263938,103.89332464938751,HOUGANG,73468,109225,-35757,91346,0.004803311174910337,1093
63081,1.3568307844677,103.89260949897677,HOUGANG,39008,54731,-15723,46869,0.0024645456993943092,560
63091,1.35385498086943,103.89147049226345,HOUGANG,62094,102207,-40113,82150,0.00431975141789333,983
63101,1.35110728949265,103.8903098431232,HOUGANG,103261,127303,-24042,115282,0.00606195475298331,1379
62231,1.34771728070981,103.89029313192805,HOUGANG,13347,14205,-858,13776,0.0007243931288240843,164
62241,1.34503285502097,103.89113604973045,HOUGANG,19576,34177,-14601,26876,0.001413239672639089,321
71051,1.34151105876514,103.89189250385124,HOUGANG,18819,29294,-10475,24056,0.0012649536227491414,287
71029,1.33654331402892,103.89504292943955,GEYLANG,38488,26548,11940,32518,0.0021719167121570498,121
71179,1.3346773011372,103.89238294056769,HOUGANG,31789,42623,-10834,37206,0.0019564293518458827,445
70149,1.33291249995394,103.88646305557553,TOA PAYOH,76181,59022,17159,67601,0.005101742407930949,621
70139,1.33218202150261,103.88328460405727,GEYLANG,49514,39185,10329,44349,0.0029621235705594748,165
70129,1.33157543468156,103.88058185579888,GEYLANG,37209,33611,3598,35410,0.00236507690440621,132
70119,1.33075033509776,103.8777335022986,GEYLANG,114325,66767,47558,90546,0.006047677305460736,337
70109,1.32946242383323,103.874037265782,GEYLANG,109553,67572,41981,88562,0.005915163535950939,330
40091,1.32101807290903,103.82350944419166,TANGLIN,19984,20677,-693,20330,0.010175638630187861,102
41011,1.32235611101422,103.81891666700089,TANGLIN,28800,26235,2565,27517,0.013772899566496773,139
41021,1.32264999998361,103.81554000003177,TANGLIN,162584,161792,792,162188,0.08117887251121048,819
41031,1.3230683576264,103.811977237669,BUKIT TIMAH,45642,42571,3071,44106,0.007313845664026744,569
41041,1.32398472197176,103.8102991670086,BUKIT TIMAH,101627,102156,-529,101891,0.01689600164497685,1315
41051,1.32612500001248,103.80715333299845,BUKIT TIMAH,147305,91569,55736,119437,0.01980555445006036,1542
41061,1.32705333303352,103.80572472199289,BUKIT TIMAH,22399,22037,362,22218,0.0036842838381024394,286
41071,1.328988333013,103.80266277802423,BUKIT TIMAH,223300,201701,21599,212500,0.03523765935713243,2743
41081,1.33082323351422,103.79727250094409,BUKIT TIMAH,139196,135740,3456,137468,0.022795532030617793,1774
42011,1.33161452117352,103.79503057628676,BUKIT TIMAH,63375,73085,-9710,68230,0.011314190578527747,880
42021,1.33254537683925,103.79237058676013,BUKIT TIMAH,9092,24432,-15340,16762,0.0027795465700906066,216
42031,1.33332611108217,103.78997500000864,BUKIT TIMAH,75327,67237,8090,71282,0.011820286279035832,920
42041,1.33442500001261,103.78689111113574,BUKIT TIMAH,99989,87412,12577,93700,0.015537734973003807,1209
42051,1.33598305556873,103.78263611110306,BUKIT TIMAH,356800,128658,228142,242729,0.040250361496928934,3133
42061,1.33687567142278,103.78038743713434,BUKIT TIMAH,32018,46392,-14374,39205,0.006501140871041774,506
42149,1.33607426889198,103.77862313710679,BUKIT TIMAH,36763,22497,14266,29630,0.004913373396479219,382
12109,1.330819444,103.7780086,BUKIT TIMAH,143669,179784,-36115,161726,0.026818097398548707,2088
12099,1.327838056,103.7767036,BUKIT TIMAH,122864,201492,-78628,162178,0.026893049972804818,2093
12089,1.326261111,103.7757089,BUKIT TIMAH,12806,11696,1110,12251,0.0020315132460434326,158
12079,1.32383187575187,103.77263094375739,BUKIT TIMAH,52477,35517,16960,43997,0.007295770817580027,568
12069,1.321433056,103.7710419,BUKIT TIMAH,47141,38131,9010,42636,0.007070083973415051,550
17119,1.31728446989719,103.77193266319905,QUEENSTOWN,38657,20384,18273,29520,0.0025635930876081884,245
17109,1.31552714122807,103.77218311911328,QUEENSTOWN,48795,27438,21357,38116,0.003310091941980817,317
17099,1.3078304704809,103.77165274445558,QUEENSTOWN,42441,118556,-76115,80498,0.0069906543484513535,670
16161,1.30107500001488,103.77369416698464,QUEENSTOWN,1722,27546,-25824,14634,0.0012708543781862543,121
16171,1.29890150201437,103.77438231319462,QUEENSTOWN,2233,26738,-24505,14485,0.0012579148331302375,120
16181,1.29656572408064,103.77254247664239,QUEENSTOWN,3007,69861,-66854,36434,0.003164022715241082,303
16191,1.29614307417349,103.7703702141818,QUEENSTOWN,127,9012,-8885,4569,0.00039678376752309667,38
16199,1.29639303583424,103.77072917887465,QUEENSTOWN,28684,11717,16967,20200,0.0017542202022251155,168
16189,1.29736100001827,103.77284799997702,QUEENSTOWN,111051,49003,62048,80027,0.006949751491260857,666
16179,1.29898164227099,103.7741773272528,QUEENSTOWN,44176,18171,26005,31173,0.002707143879404135,259
16169,1.30098333297992,103.77270416701658,QUEENSTOWN,55451,7404,48047,31427,0.0027292018958083517,261
17091,1.30904805161426,103.77157783850733,QUEENSTOWN,99010,24814,74196,61912,0.00537659807723571,515
17101,1.31487473157856,103.77179195235537,QUEENSTOWN,41745,74554,-32809,58149,0.005049809432633081,484
17111,1.31779809827118,103.77124639148465,CLEMENTI,32590,51165,-18575,41877,0.00389863384429763,170
12061,1.32178500189496,103.77087339859139,CLEMENTI,76769,107166,-30397,91967,0.008561875462867926,373
12071,1.32402249998323,103.77219388896603,CLEMENTI,27871,53692,-25821,40781,0.003796599250287787,165
12081,1.326468056,103.77543,CLEMENTI,11929,12725,-796,12327,0.0011476098908388109,50
12091,1.32918315486756,103.7771471166854,BUKIT TIMAH,240715,150522,90193,195618,0.032438213873522505,2525
12101,1.33243896358504,103.77768506316727,BUKIT TIMAH,244094,180507,63587,212300,0.0352044945012669,2741
42141,1.33608648972914,103.77817465012919,BUKIT TIMAH,6505,28589,-22084,17547,0.002909718629362837,226
42059,1.33679896138996,103.78180146215335,BUKIT TIMAH,126440,374167,-247727,250303,0.041506314588556796,3231
42049,1.33580349277905,103.7846322701164,BUKIT TIMAH,8470,11190,-2720,9830,0.0016300526657911144,126
42039,1.33474752657285,103.7877986922408,BUKIT TIMAH,56946,67388,-10442,62167,0.01030879797296401,802
42029,1.33325151466609,103.79206171859214,BUKIT TIMAH,38051,39954,-1903,39002,0.006467478542338255,503
42019,1.33170368135595,103.79657033601987,BUKIT TIMAH,103599,88367,15232,95983,0.015916311802708905,1239
41089,1.33044921085796,103.79993319513187,BUKIT TIMAH,19410,17185,2225,18297,0.003034086838858598,236
41079,1.32940305598521,103.80304777797754,BUKIT TIMAH,218278,136302,81976,177290,0.02939898648200475,2289
41069,1.32652777798065,103.80758583296918,BUKIT TIMAH,106705,144944,-38239,125824,0.020864674122126264,1624
41049,1.32469500003392,103.81026249997407,BUKIT TIMAH,71933,66781,5152,69357,0.011501074541330043,895
41029,1.32333331915013,103.81630566925632,NOVENA,91656,71005,20651,81330,0.014048621739175496,693
41019,1.32267444098276,103.82025232877241,NOVENA,24211,20036,4175,22123,0.0038214393057393273,188
40099,1.32185235205471,103.82344007494515,NOVENA,11467,11960,-493,11713,0.0020232571797733014,99
70101,1.3296996501314,103.87395296821519,TOA PAYOH,79741,136591,-56850,108166,0.00816311991385126,994
70111,1.3307766855737,103.87714812684305,TOA PAYOH,44432,89449,-45017,66940,0.005051857765223854,615
70121,1.3319080537309,103.88114282141879,TOA PAYOH,65749,73602,-7853,69675,0.005258263964624619,640
70131,1.3327616336301,103.88503448837113,TOA PAYOH,56869,63052,-6183,59960,0.004525088013188262,551
70141,1.33325940650465,103.88723373413463,TOA PAYOH,25201,18534,6667,21867,0.0016502685054100687,201
71011,1.33411688207761,103.89054392713261,GEYLANG,42511,29270,13241,35890,0.0023971366873521286,133
71171,1.33497828854869,103.89238738026172,HOUGANG,955,6328,-5373,3641,0.0001914572722160635,43
71021,1.33655775095595,103.89468782549605,GEYLANG,11943,27248,-15305,19595,0.0013087738475526596,73
71069,1.3385251356058,103.89512258677937,HOUGANG,38717,28586,10131,33651,0.0017694942783144062,402
71059,1.34065465828861,103.89195372882892,HOUGANG,29441,21262,8179,25351,0.0013330495215461207,303
62249,1.34421563693504,103.89102556910234,HOUGANG,41741,16457,25284,29099,0.0015301332502651007,348
62239,1.34763066655635,103.88998897946436,HOUGANG,11108,20515,-9407,15811,0.0008314009697907663,189
63109,1.35081444397072,103.88984416702769,HOUGANG,144823,108242,36581,126532,0.006653521441374059,1514
64241,1.36712666702422,103.89641722203109,HOUGANG,115191,83678,31513,99434,0.005228608186084059,1189
11091,1.31219444050072,103.80367378215983,TANGLIN,27130,17994,9136,22562,0.011292806629330965,114
11101,1.31614971080385,103.80596012189226,BUKIT TIMAH,99000,94959,4041,96979,0.01608147278491928,1252
11111,1.31780157259006,103.80771866952543,BUKIT TIMAH,119094,161795,-42701,140444,0.02328902508589698,1813
41101,1.31908138967253,103.80921733406133,BUKIT TIMAH,33024,42568,-9544,37796,0.006267494461469071,487
41111,1.32081170217365,103.81185140010722,BUKIT TIMAH,13646,23687,-10041,18666,0.003095275997930513,240
66081,1.34302188357133,103.86962821126625,SERANGOON,11130,7314,3816,9222,0.0009365199519777103,109
41119,1.32074221277671,103.81245374678939,BUKIT TIMAH,32951,25357,7594,29154,0.004834441039519242,376
41109,1.31944666701923,103.81052861101583,TANGLIN,20799,25064,-4265,22931,0.011477499725963495,115
11119,1.31747833490912,103.80785606728587,TANGLIN,189432,94515,94917,141973,0.07106079406018993,717
11109,1.31552472199926,103.80574305602846,TANGLIN,66264,61897,4367,64080,0.032073532878624605,323
11099,1.31305333300118,103.80437666697586,BUKIT TIMAH,19847,30279,-10432,25063,0.004156053912789695,323
22009,1.33932334709184,103.70545701843297,JURONG WEST,6393645,5536337,857308,5964991,0.2450567782827685,32063
21699,1.34154982082089,103.71203075013112,JURONG WEST,58940,21556,37384,40248,0.0016534886997021231,216
21689,1.34241984576482,103.71442338427325,JURONG WEST,131133,37884,93249,84508,0.0034718004132982265,454
28099,1.344324,103.719266,JURONG WEST,637145,615469,21676,626307,0.02573026105755162,3366
21669,1.34134214489014,103.7220951930324,JURONG EAST,27354,24564,2790,25959,0.0025316835925076834,198
21659,1.33896010542304,103.72410808486939,JURONG EAST,10077,18417,-8340,14247,0.0013894563019552742,109
21649,1.33670886560508,103.72517977728532,JURONG WEST,19213,41717,-22504,30465,0.0012515785439382125,163
21639,1.33378861099344,103.72511638897618,JURONG WEST,22156,33606,-11450,27881,0.0011454213485488694,149
21759,1.33032387572414,103.7249113116863,JURONG EAST,8795,35317,-26522,22056,0.0021510386885607866,169
21769,1.32847554099899,103.7249037836336,JURONG EAST,9873,18316,-8443,14094,0.0013745347876575865,108
21779,1.32643572160288,103.72425774502393,JURONG WEST,101638,93604,8034,97621,0.0040105153138943785,524
21559,1.326626598883,103.72063909698713,JURONG WEST,51783,65177,-13394,58480,0.002402504948285136,314
21179,1.32586166697514,103.71929527796603,BOON LAY,76671,49687,26984,63179,0.08428215625929647,0
21029,1.32429728567538,103.72180766916203,JURONG WEST,24857,5913,18944,15385,0.0006320543541273396,82
21019,1.32554867828642,103.72703317988619,JURONG EAST,66795,16171,50624,41483,0.004045680899418168,317
20089,1.32702967705527,103.7392229529496,JURONG EAST,10592,7003,3589,8797,0.0008579383089984241,67
20069,1.32405636523113,103.74418793943124,JURONG EAST,3999,5398,-1399,4698,0.0004581782625525289,36
20059,1.32332108750232,103.74769351004639,JURONG EAST,42294,33237,9057,37765,0.0036830783493606327,289
20039,1.32102499760642,103.75471510655738,CLEMENTI,120632,42685,77947,81658,0.007602135837277166,331
20029,1.31772833949651,103.75767989744158,CLEMENTI,77460,29475,47985,53467,0.00497763105650026,217
17059,1.31694333299923,103.76170111103328,CLEMENTI,43197,32908,10289,38052,0.0035425368350935696,154
82229,1.31753161766428,103.90052963468462,GEYLANG,11325,9632,1693,10478,0.0006998383452236167,39
17051,1.31726409983754,103.76240145648879,CLEMENTI,33642,32289,1353,32965,0.0030689510871664966,133
20021,1.31675923723731,103.75788959223745,CLEMENTI,55666,133526,-77860,94596,0.008806628152331318,384
20031,1.32055987103977,103.75464677812963,CLEMENTI,43145,147709,-104564,95427,0.008883991973154474,387
20051,1.32258708167298,103.74754428861822,JURONG EAST,19845,53155,-33310,36500,0.0035597076592522995,279
20061,1.32380614051658,103.74298566424717,JURONG EAST,4408,7848,-3440,6128,0.0005976407818054271,46
20081,1.32660472912447,103.73879228035435,JURONG EAST,10334,17160,-6826,13747,0.0013406931833353797,105
21011,1.32534328766029,103.72866849877529,JURONG EAST,18789,81400,-62611,50094,0.004885479328289991,383
21021,1.32419322170223,103.72379008890384,JURONG EAST,1736,7690,-5954,4713,0.0004596411561111257,36
21171,1.3258163890121,103.71906611098208,BOON LAY,27956,70478,-42522,49217,0.06565654544411582,0
21551,1.3266610431866,103.7209862100987,JURONG WEST,81721,66638,15083,74179,0.003047459209282543,398
21771,1.3265799244816,103.72373023682435,JURONG WEST,59026,42376,16650,50701,0.0020829241344563045,272
21761,1.32831333299986,103.72476805601295,JURONG EAST,39653,10444,29209,25048,0.0024428371903822354,192
21751,1.33089333300685,103.72480472198433,JURONG EAST,39133,9594,29539,24363,0.00237603171787298,186
21631,1.33363626085559,103.72493610114242,JURONG WEST,48783,25286,23497,37034,0.001521449525560734,199
21641,1.3363012622323,103.7250086693193,JURONG WEST,74997,24350,50647,49673,0.0020406913183339185,267
21651,1.33873014874255,103.72402172321266,JURONG WEST,64308,12758,51550,38533,0.0015830322019882207,207
21661,1.34176560473259,103.72141430185464,JURONG WEST,60071,45637,14434,52854,0.0021713747697787718,284
28091,1.34425795644531,103.72012487725401,JURONG WEST,1168625,1519544,-350919,1344084,0.05521833893486455,7224
21681,1.34228732259066,103.71466298692037,JURONG WEST,36276,91588,-55312,63932,0.002626486770755221,343
21691,1.34107859811695,103.71138811111824,JURONG WEST,12261,57878,-45617,35069,0.0014407224013579247,188
52251,1.3329698063249,103.85142087938439,TOA PAYOH,46494,17286,29208,31890,0.00240668873816834,293
93031,1.30983637164414,103.92937539318251,BEDOK,83919,86849,-2930,85384,0.0034772125171668635,466
93041,1.31120679321816,103.9333999156994,BEDOK,39461,48507,-9046,43984,0.0017912221886426886,240
84169,1.322133056,103.9321144,BEDOK,3819,7673,-3854,5746,0.00023400242578985287,31
84161,1.321651111,103.9324025,BEDOK,6929,5101,1828,6015,0.00024495729048485293,32
93049,1.31073016722066,103.9329857782451,BEDOK,51225,49121,2104,50173,0.0020432655254358314,274
93039,1.30958474832555,103.92954154203639,BEDOK,46647,30939,15708,38793,0.0015798218071120366,212
93201,1.30920003741893,103.92781269211483,BEDOK,99842,63458,36384,81650,0.003325147592367123,446
83131,1.31631138897106,103.90907722199168,BEDOK,15594,9490,6104,12542,0.0005107654758538696,68
83141,1.31763611995973,103.90845006395246,BEDOK,9354,10474,-1120,9914,0.00040374174195624806,54
83029,1.31774429797349,103.90635251996308,BEDOK,54487,36549,17938,45518,0.0018536934244870384,248
52259,1.33278746546959,103.85165691373105,TOA PAYOH,13703,50096,-36393,31899,0.0024073679541809934,293
67009,1.39178060381601,103.89588499436073,SENGKANG,1274055,1167002,107053,1220528,0.09432509796099398,11552
66489,1.37889334025536,103.8789799431682,HOUGANG,178058,141646,36412,159852,0.008405610513123368,1912
54531,1.35839974282084,103.85132688003488,BISHAN,33142,36560,-3418,34851,0.004573041114986968,399
53241,1.35615639153054,103.84995659632311,BISHAN,74597,60769,13828,67683,0.008881155254818023,775
52019,1.34403333300249,103.84368166701324,TOA PAYOH,35454,18596,16858,27025,0.002039534749106284,248
51139,1.34436688449065,103.84032264966956,TOA PAYOH,7902,14706,-6804,11304,0.0008530953118925969,103
42129,1.33016133420747,103.79515526101162,BUKIT TIMAH,50306,13895,36411,32100,0.005322959366418594,414
42139,1.32877805376848,103.7944440268283,BUKIT TIMAH,3863,4116,-253,3989,0.0006614730502381237,51
11349,1.32566611098306,103.79307388903305,BUKIT TIMAH,20472,29695,-9223,25083,0.0041593703983762486,323
11339,1.32398638897489,103.79204722198944,BUKIT TIMAH,8052,4948,3104,6500,0.0010778578156299334,83
11329,1.32236139685053,103.7909809400838,BUKIT TIMAH,11059,12063,-1004,11561,0.001917094493307332,149
11319,1.3203063798654,103.78959970624805,BUKIT TIMAH,4670,3745,925,4207,0.0006976227431315583,54
11309,1.31862443850443,103.78842993526158,BUKIT TIMAH,4452,5069,-617,4760,0.0007893235695997665,61
11291,1.31792777802094,103.78592333300938,BUKIT TIMAH,32935,47686,-14751,40310,0.006684376699698863,520
12021,1.31907638897016,103.78243055601493,BUKIT TIMAH,28685,30237,-1552,29461,0.004885349093272841,380
12031,1.3208008510991,103.7796285552172,BUKIT TIMAH,58657,66628,-7971,62642,0.010387564505644658,808
12041,1.32049172685895,103.77653442120544,BUKIT TIMAH,18320,22038,-3718,20179,0.003346168132553296,260
12051,1.3204289505949,103.7750613105408,BUKIT TIMAH,32212,24255,7957,28233,0.004681716878258447,364
12111,1.3191179107649,103.77222980786665,BUKIT TIMAH,9334,12006,-2672,10670,0.0017693450604263673,137
17249,1.315171111,103.7693364,CLEMENTI,36655,25356,11299,31005,0.0028864804628423242,125
17241,1.31519114798349,103.76905503649127,CLEMENTI,32526,43357,-10831,37941,0.0035322030395323538,154
12119,1.31964598192789,103.77279266281438,BUKIT TIMAH,15875,15841,34,15858,0.002629641421578382,204
12059,1.32072731097778,103.77515897833835,BUKIT TIMAH,15945,24071,-8126,20008,0.0033178121807882622,258
12049,1.32091131971837,103.77655888991401,BUKIT TIMAH,20530,20200,330,20365,0.003377011448508245,262
12039,1.32104526183447,103.78018998386835,BUKIT TIMAH,30055,31372,-1317,30713,0.005092961090991098,396
12029,1.31958369390988,103.7824392109149,BUKIT TIMAH,27121,20748,6373,23934,0.003968838301428742,309
11299,1.31826975603165,103.78558843680226,BUKIT TIMAH,34359,16077,18282,25218,0.004181756676085485,325
11301,1.31803972093441,103.78790067716272,BUKIT TIMAH,5452,8220,-2768,6836,0.0011335747734840345,88
11311,1.31989638898836,103.78918694402276,BUKIT TIMAH,3129,4163,-1034,3646,0.0006045953224287288,47
11321,1.32123138902898,103.79010361098513,BUKIT TIMAH,3969,8627,-4658,6298,0.0010443613112057415,81
11331,1.32320918827361,103.79144668575621,BUKIT TIMAH,8698,9230,-532,8964,0.0014864488398933417,115
11341,1.32551506183496,103.79282790894261,BUKIT TIMAH,24457,26274,-1817,25365,0.004206132845146655,327
42131,1.32858335781449,103.79421797943384,BUKIT TIMAH,3746,11504,-7758,7625,0.0012644101298735755,98
51131,1.34429,103.839394,BISHAN,9709,5958,3751,7833,0.0010278221874176613,89
52011,1.34504127313408,103.84263401771713,BISHAN,21712,18532,3180,20122,0.0026403470005385145,230
53249,1.35538305217047,103.84911895270494,BISHAN,75760,99848,-24088,87804,0.011521371038429764,1006
54539,1.35857111103202,103.85104805599867,BISHAN,28708,17443,11265,23075,0.003027830585300975,264
66481,1.3791866640778,103.8783096213561,HOUGANG,136873,241291,-104418,189082,0.009942632228826619,2262
52261,1.33403167346972,103.85128140448401,TOA PAYOH,74115,20638,53477,47376,0.0035753930906071898,435
52029,1.34359918269745,103.84736537931644,TOA PAYOH,19581,11693,7888,15637,0.0011801000877622557,143
51079,1.34178289872759,103.83615392311769,CENTRAL WATER CATCHMENT,77189,84502,-7313,80845,0.17315308021649223,0
51119,1.34014305601694,103.83257583298696,NOVENA,3073,3339,-266,3206,0.0005537917287076926,27
40269,1.34105638903249,103.82660805601813,NOVENA,106,143,-37,124,2.1419268359249498e-05,1
40259,1.34031250739109,103.82256277806692,NOVENA,349,462,-113,405,6.995809423787134e-05,3
41159,1.33870170002583,103.81989450001056,NOVENA,3123,2116,1007,2619,0.000452395676071568,22
41169,1.33507722199373,103.82011297432192,NOVENA,6844,6236,608,6540,0.0011296936699152556,55
41139,1.32962999996746,103.81485527800427,NOVENA,28199,17486,10713,22842,0.003945636515015944,194
41129,1.32542946413096,103.81399869920736,NOVENA,34405,31780,2625,33092,0.005716180875357132,281
42071,1.33876225175982,103.77694915592028,BUKIT TIMAH,226767,210155,16612,218461,0.03622613788620475,2820
42151,1.34009254981171,103.77531978477353,BUKIT TIMAH,509009,104935,404074,306972,0.05090341067377721,3963
42161,1.34027669212035,103.77264625507586,BUKIT TIMAH,122900,82330,40570,102615,0.017016058423210093,1324
42171,1.34261833302181,103.77026361103131,BUKIT TIMAH,26215,58734,-32519,42474,0.007043220440163967,548
42181,1.3436280559857,103.76943333300858,BUKIT TIMAH,25689,47591,-21902,36640,0.00607580159456627,473
42191,1.34642944402637,103.76696388898718,BUKIT TIMAH,14939,28364,-13425,21651,0.003590261471723644,279
43201,1.34694499998204,103.76464638897035,BUKIT TIMAH,20185,20450,-265,20317,0.003369051883100516,262
43191,1.34638492790435,103.75931336284916,BUKIT BATOK,94861,96179,-1318,95520,0.0076857543513181486,595
43419,1.35155523613685,103.74998784769572,BUKIT BATOK,344619,356779,-12160,350699,0.028218031462028094,2186
43401,1.35226498779767,103.74681637316733,BUKIT BATOK,113257,132119,-18862,122688,0.009871752825110144,764
43531,1.35154868659228,103.7437763360561,BUKIT BATOK,80851,121171,-40320,101011,0.008127572579365552,629
43341,1.34972199038423,103.74139303669513,BUKIT BATOK,146942,109925,37017,128433,0.010334008465272652,800
43453,1.3479,103.7385,BUKIT BATOK,21161,28892,-7731,25026,0.0020136483291047736,156
28299,1.34438323067917,103.73667027224192,JURONG EAST,182752,236432,-53680,209592,0.02044071911556186,1606
28451,1.34394189080479,103.73465998158574,JURONG EAST,104204,142175,-37971,123189,0.01201415963933237,944
28461,1.345332402809,103.73205383657178,JURONG EAST,314639,303233,11406,308936,0.030129365627911464,2368
28491,1.34905596073619,103.7307863306416,JURONG EAST,314338,317951,-3613,316144,0.03083233474593586,2423
28501,1.34980328426271,103.72737769835274,JURONG WEST,164440,194673,-30233,179556,0.007376610439368774,965
28511,1.35063596491215,103.7237236090261,JURONG WEST,561796,428311,133485,495053,0.0203380178208516,2661
28521,1.35097548065061,103.72120042369096,JURONG WEST,204742,124882,79860,164812,0.006770889971558992,885
28401,1.3506545513673,103.71861401513462,JURONG WEST,505285,382216,123069,443750,0.018230362017810007,2385
28531,1.35006115514965,103.71652940446651,JURONG WEST,102163,65114,37049,83638,0.00343605863311683,449
21161,1.35043949411648,103.7127413228723,JURONG WEST,49843,34327,15516,42085,0.001728957263142612,226
21389,1.350059,103.709927,JURONG WEST,34943,21893,13050,28418,0.0011674826542470416,152
21379,1.34534855216089,103.70648912988919,JURONG WEST,161933,167238,-5305,164585,0.006761564242707064,884
21369,1.34309123717886,103.70800310705765,JURONG WEST,56937,47476,9461,52206,0.002144753305919525,280
21361,1.34302323304896,103.70767181671128,JURONG WEST,79558,40303,39255,59930,0.002462074581920797,322
21371,1.34522722613512,103.70617873626036,JURONG WEST,172029,167514,4515,169771,0.0069746181185929524,912
21381,1.350462,103.709815,JURONG WEST,9742,33843,-24101,21792,0.0008952699697850493,117
21169,1.35074356093462,103.71275812568066,JURONG WEST,5176,12798,-7622,8987,0.00036920848102323046,48
28539,1.34975477386966,103.71542393424821,JURONG WEST,73831,101969,-28138,87900,0.003611152273499717,472
28409,1.35081149361542,103.71793769087185,JURONG WEST,234423,402402,-167979,318412,0.01308116288634348,1711
28529,1.35117921308914,103.7206511492765,JURONG WEST,145424,179713,-34289,162568,0.0066787008281945625,873
28519,1.35058416759245,103.72452492776075,JURONG WEST,292989,452037,-159048,372513,0.01530376754104892,2002
28509,1.35003470887569,103.72654009750788,JURONG WEST,206704,140688,66016,173696,0.0071358669544687925,933
28499,1.34963044051902,103.73046199733298,JURONG EAST,340774,311229,29545,326001,0.031793650866408465,2498
28469,1.34612717332075,103.73193313637753,JURONG EAST,225836,205759,20077,215797,0.02104586941763475,1654
28459,1.34440772894012,103.7343152870331,JURONG EAST,191271,135511,55760,163391,0.01593490942884637,1252
28291,1.34446090409168,103.73638303040048,JURONG EAST,190140,125265,64875,157702,0.015380082665189209,1208
43459,1.34808666498981,103.73807456781998,TENGAH,28627,24181,4446,26404,0.1435905244610733,1
43349,1.34989138902216,103.74073750002215,BUKIT BATOK,125280,147827,-22547,136553,0.010987361954936633,851
43539,1.35142277800259,103.7433686110311,BUKIT BATOK,146328,75296,71032,110812,0.008916183115350364,690
43409,1.35235542005389,103.74623591627208,BUKIT BATOK,119868,106794,13074,113331,0.009118867529200556,706
43411,1.35176519952681,103.75019891787089,BUKIT BATOK,228747,282891,-54144,255819,0.020583772952259813,1594
43199,1.34663409083885,103.75920055445125,BUKIT BATOK,66272,64255,2017,65263,0.0052512079797956066,406
43209,1.34697997431974,103.76384248905434,BUKIT BATOK,16981,21522,-4541,19251,0.0015489788213696157,120
42199,1.34607666698124,103.76760722200575,BUKIT TIMAH,27493,22143,5350,24818,0.004115426964354413,320
42189,1.34378853697493,103.76960174742553,BUKIT TIMAH,83427,41814,41613,62620,0.01038391637149945,808
42179,1.34197833300345,103.77100805601951,BUKIT TIMAH,13766,24082,-10316,18924,0.003138058661997055,244
42169,1.34038575681297,103.77366130505683,BUKIT TIMAH,49888,136574,-86686,93231,0.015459963385999125,1203
42159,1.34036805329812,103.77530898996658,BUKIT TIMAH,73954,381129,-307175,227541,0.0377318223425001,2937
42259,1.34106160633217,103.7770788000345,BUKIT TIMAH,35781,41696,-5915,38738,0.006423700932595747,500
42089,1.34007090936874,103.77941451542826,BUKIT TIMAH,92347,105801,-13454,99074,0.01642887465011077,1279
41121,1.32554444399609,103.81350777801268,NOVENA,30295,33137,-2842,31716,0.005478496090983525,270
41131,1.32973612368298,103.8145129140827,NOVENA,12880,26025,-13145,19452,0.0033600613558396873,165
41141,1.33489306619804,103.81796101152241,BUKIT TIMAH,1569,3234,-1665,2401,0.0003981440946657646,30
41151,1.33799972901638,103.81931795640678,CENTRAL WATER CATCHMENT,3516,1631,1885,2573,0.005510827823576405,0
40251,1.34054275997605,103.82231128179984,CENTRAL WATER CATCHMENT,739,588,151,663,0.0014200073249246625,0
40261,1.34130384192273,103.82706642150467,CENTRAL WATER CATCHMENT,252,166,86,209,0.0004476342849310022,0
51111,1.34064833298154,103.83271333302345,CENTRAL WATER CATCHMENT,4819,9794,-4975,7306,0.015647923855052162,0
52269,1.33404239936331,103.85147452356613,TOA PAYOH,79754,129454,-49700,104604,0.007894301309732238,961
62179,1.348559,103.874826,SERANGOON,8273,4302,3971,6287,0.0006384624743096795,74
62169,1.34763166701234,103.8764688890183,SERANGOON,9511,11917,-2406,10714,0.00108803673449243,127
62159,1.34592441628878,103.8776519633928,SERANGOON,713,4091,-3378,2402,0.00024392983351230322,28
62069,1.34209858960795,103.88161305566761,SERANGOON,7773,16693,-8920,12233,0.0012422954426960888,145
70309,1.33965000001824,103.88639700003634,TOA PAYOH,74895,111640,-36745,93267,0.007038715539126578,857
70299,1.3374750000156,103.88758305557131,HOUGANG,68230,111722,-43492,89976,0.004731271498190752,1076
70289,1.3350640000249,103.8886929999761,HOUGANG,110400,97798,12602,104099,0.0054739111728700895,1245
70279,1.33155751923227,103.88951499040957,GEYLANG,140747,137245,3502,138996,0.009283711646564403,518
70269,1.32824611112671,103.89014388885742,GEYLANG,71127,63227,7900,67177,0.004486833414495791,250
91089,1.29913832558004,103.88553021350832,MARINE PARADE,28430,42208,-13778,35319,0.008986035122856725,220
90069,1.29795473961403,103.88258182953015,KALLANG,7026,72242,-65216,39634,0.0040249830455942005,206
90059,1.297578611,103.8791081,KALLANG,50,1111,-1061,580,5.890120014241904e-05,3
90051,1.297659444,103.8791731,KALLANG,12921,1449,11472,7185,0.0007296640052125531,37
90061,1.2981225,103.8824094,KALLANG,67339,3556,63783,35447,0.0035997773128419444,184
91081,1.29930499999248,103.88533388902762,KALLANG,36987,24989,11998,30988,0.003146948948298761,161
70261,1.32884296980066,103.88962746952593,GEYLANG,74766,91648,-16882,83207,0.005557496582460533,310
70271,1.33078171512111,103.88931512831826,GEYLANG,108310,124894,-16584,116602,0.007787989189708355,435
70281,1.33530627797371,103.8879999999696,TOA PAYOH,194120,191977,2143,193048,0.014569032534522474,1775
70291,1.33743499996855,103.88713611112668,TOA PAYOH,97922,79212,18710,88567,0.006684013843629833,814
70301,1.33965760027057,103.88575915318087,TOA PAYOH,113512,64430,49082,88971,0.006714503095753383,818
62061,1.34173536917551,103.88178158303499,TOA PAYOH,9813,6542,3271,8177,0.0006171054817184859,75
62151,1.34568958726335,103.87754406103582,SERANGOON,2520,1569,951,2044,0.00020757392993303405,24
62161,1.34750333302055,103.87601972203167,SERANGOON,36266,6053,30213,21159,0.002148755764898761,251
62171,1.348208,103.874638,SERANGOON,2227,4123,-1896,3175,0.0003224301504586023,37
66539,1.37500340591534,103.8750162086281,SERANGOON,52779,54490,-1711,53634,0.0054466830518729685,636
66529,1.37512174055594,103.87318199195964,SERANGOON,64519,68446,-3927,66482,0.0067514334685948975,789
66519,1.3773461218142,103.87159967372142,SERANGOON,9443,8671,772,9057,0.0009197637394341925,107
66459,1.37848946701219,103.87075091953804,SERANGOON,82780,55103,27677,68941,0.007001151811894961,818
54659,1.37834008020794,103.86686274044777,SERANGOON,155110,127955,27155,141532,0.014372971355813197,1680
54509,1.37758835823729,103.86257049780349,SERANGOON,61005,22233,38772,41619,0.004226526120294983,494
54499,1.37700806651463,103.86055355422364,SERANGOON,19544,16694,2850,18119,0.001840035242884855,215
54489,1.37566138900563,103.855796667004,ANG MO KIO,498644,269405,229239,384024,0.022783336241389073,3697
54479,1.37579335077466,103.853200441537,ANG MO KIO,110827,40201,70626,75514,0.004480086799086137,727
54359,1.37615334768079,103.8499921086812,ANG MO KIO,118780,142463,-23683,130621,0.007749469208139289,1257
54349,1.37477333299627,103.84810527802902,ANG MO KIO,42745,35157,7588,38951,0.002310880908324339,375
54399,1.37137302300723,103.84866111647399,ANG MO KIO,26063,421012,-394949,223537,0.0132619800673692,2152
54391,1.37161972202016,103.8482886110145,ANG MO KIO,240195,85534,154661,162864,0.009662378584717597,1568
54341,1.37462142095238,103.84782467173312,ANG MO KIO,18194,43406,-25212,30800,0.0018272992214934053,296
54351,1.37647777885877,103.85003474200923,ANG MO KIO,121326,63270,58056,92298,0.005475846219006439,888
54471,1.37613470846106,103.853296559924,ANG MO KIO,29361,40536,-11175,34948,0.0020733913374269978,336
54481,1.37599497932237,103.855765341723,ANG MO KIO,279218,532368,-253150,405793,0.02407484522686602,3906
54491,1.37717165299187,103.86010323265269,SERANGOON,6260,9153,-2893,7706,0.0007825659021839336,91
54501,1.37787138898682,103.86266305598139,SERANGOON,22905,56418,-33513,39661,0.0040276857314452364,470
54651,1.37854275740549,103.86551861831312,SERANGOON,45392,78904,-33512,62148,0.006311303619118493,737
66451,1.37872496881803,103.86854361874474,SERANGOON,59682,40910,18772,50296,0.005107699794477436,597
66511,1.37665021193432,103.87172116805385,SERANGOON,43485,24803,18682,34144,0.003467418915671974,405
66521,1.37522304448462,103.87393140656636,SERANGOON,17119,13865,3254,15492,0.0015732560286313912,183
66531,1.37519277744949,103.87488352078606,SERANGOON,17384,10861,6523,14122,0.0014341286881185454,167
92181,1.30528972611328,103.90534997934479,MARINE PARADE,35246,26960,8286,31103,0.007913379496197873,194
92171,1.30837865741776,103.90304313394574,MARINE PARADE,51403,21998,29405,36700,0.009337395991076807,228
82139,1.30938972202558,103.89936888898059,MARINE PARADE,60100,15435,44665,37767,0.009608867422207025,235
82129,1.30943460005849,103.8966101212743,MARINE PARADE,78606,17413,61193,48009,0.012214687851106444,299
13139,1.2950426189642,103.83205533028763,SINGAPORE RIVER,73012,182648,-109636,127830,0.09712285969572274,168
13119,1.29362677394379,103.83283853530904,SINGAPORE RIVER,74159,39725,34434,56942,0.04326347396381009,74
06129,1.29078162052352,103.83440916705554,BUKIT MERAH,54593,71926,-17333,63259,0.0036864685293514494,557
06131,1.29152472200833,103.83222750001508,BUKIT MERAH,53692,60866,-7174,57279,0.0033379792739803293,504
13121,1.29409221679274,103.8308377640795,SINGAPORE RIVER,187145,120750,66395,153947,0.116966071200637,202
82121,1.30965150589688,103.8965764453886,GEYLANG,23002,59446,-36444,41224,0.00275340102533865,153
82131,1.30955979607535,103.90034889101835,GEYLANG,21653,85495,-63842,53574,0.003578272524051349,199
92179,1.30803621256234,103.90349800941955,MARINE PARADE,15983,47757,-31774,31870,0.008108523439662611,198
92189,1.3047647219741,103.90592361097,MARINE PARADE,21318,42127,-20809,31722,0.008070868545747643,197
28071,1.33765035288669,103.73904242961275,JURONG EAST,47402,34186,13216,40794,0.003978485321959954,312
28081,1.33950830792818,103.73664764665054,JURONG EAST,43740,51937,-8197,47838,0.004665460137077027,366
28281,1.3420603281321,103.73537548132207,JURONG EAST,86326,73813,12513,80069,0.007808828289552668,613
43761,1.35079436745796,103.73765826692882,BUKIT BATOK,6397,4482,1915,5439,0.0004376341909214762,33
43751,1.356298,103.736664,BUKIT BATOK,25569,57848,-32279,41708,0.003355919624003113,260
43781,1.35886131299107,103.73860159776643,BUKIT BATOK,29676,24746,4930,27211,0.002189458350646128,169
43771,1.36200917978122,103.74136328540868,TENGAH,7273,7469,-196,7371,0.04008505362076092,0
43671,1.36459985984635,103.743456828696,TENGAH,13320,18475,-5155,15897,0.08645124099976072,0
44171,1.36801215768924,103.74704828649467,TENGAH,629,6534,-5905,3581,0.019474233756063605,0
44161,1.37071120082306,103.74995297031272,CHOA CHU KANG,18881,21232,-2351,20056,0.001694908092476268,325
44151,1.37392273953012,103.75223395114867,CHOA CHU KANG,52170,144920,-92750,98545,0.008327917729012455,1599
44131,1.37710069702793,103.75532192967427,CHOA CHU KANG,119353,125712,-6359,122532,0.010355029835824793,1988
44141,1.37835602806756,103.75773677895589,CHOA CHU KANG,207501,255061,-47560,231281,0.019545275156362372,3754
44041,1.3809505774787,103.7603697770399,CHOA CHU KANG,119059,91084,27975,105071,0.008879422027551553,1705
44051,1.38440811744123,103.75801976703181,CHOA CHU KANG,47047,39578,7469,43312,0.003660244281079583,703
43991,1.386207,103.7565,BUKIT PANJANG,17973,12719,5254,15346,0.001830294074324538,124
44061,1.38792499938306,103.7553863903753,CHOA CHU KANG,10261,9835,426,10048,0.000849144221838928,163
45011,1.3902154350718,103.75455779683573,SUNGEI KADUT,6113,14070,-7957,10091,0.004512410582409961,1
45021,1.39385694401888,103.75383583300305,SUNGEI KADUT,27926,28129,-203,28027,0.012532883895867998,4
45031,1.39623361717149,103.75421868895825,SUNGEI KADUT,12047,11647,400,11847,0.0052976442542672485,1
45041,1.40062703005588,103.75556160767161,SUNGEI KADUT,7078,8329,-1251,7703,0.0034445643361712347,1
45051,1.403385556,103.7560103,SUNGEI KADUT,23488,29220,-5732,26354,0.01178476548298802,4
45061,1.40718111138275,103.75606300126093,SUNGEI KADUT,129209,123608,5601,126408,0.05652609225064695,20
45071,1.40955433592964,103.75568311864467,SUNGEI KADUT,77094,8693,68401,42893,0.019180539798960505,7
45091,1.41421866753882,103.75523144616068,SUNGEI KADUT,5583,3853,1730,4718,0.002109756528372827,0
45101,1.41863235748269,103.75457151987825,SUNGEI KADUT,1084,579,505,831,0.00037159976156799895,0
45111,1.42170099129292,103.75566245596836,SUNGEI KADUT,1501,1351,150,1426,0.0006376669795378658,0
45121,1.42402638898738,103.75863222200965,SUNGEI KADUT,4021,17948,-13927,10984,0.004911734995262215,1
45131,1.42513583961154,103.76103770449444,SUNGEI KADUT,275617,255560,20057,265588,0.11876346266585043,43
46389,1.42930397640592,103.76660954719264,SUNGEI KADUT,57234,24180,33054,40707,0.01820302225529306,6
46499,1.4322913388299,103.77219638823969,WOODLANDS,36924,76791,-39867,56857,0.0022597283437467424,576
46519,1.43554811627266,103.77213801008084,WOODLANDS,66521,15135,51386,40828,0.0016226707145732626,413
46509,1.43804390195153,103.7709643228368,WOODLANDS,25985,16570,9415,21277,0.0008456344859894021,215
46101,1.44460832436456,103.76774882217022,WOODLANDS,1848464,1390255,458209,1619359,0.06435991049477427,16420
46109,1.44694093553778,103.76925342517902,WOODLANDS,1226264,1184770,41494,1205517,0.047912146855594584,12223
46059,1.4387537800127,103.76656472079625,SUNGEI KADUT,41712,33284,8428,37498,0.01676804796543541,6
46049,1.43709,103.76476,SUNGEI KADUT,14196,8626,5570,11411,0.0051026773516876485,1
46039,1.4330873187738,103.76200180616921,SUNGEI KADUT,59671,10843,48828,35257,0.01576593597304806,5
46029,1.42861423605127,103.76226643430736,SUNGEI KADUT,3389,42772,-39383,23080,0.010320725026461391,3
45139,1.42525961270458,103.76178101875855,SUNGEI KADUT,936543,901119,35424,918831,0.41087530748650547,152
45129,1.42382925070118,103.75863462427267,SUNGEI KADUT,14245,2739,11506,8492,0.003797382882353125,1
45119,1.42181345656216,103.75597729351239,SUNGEI KADUT,1300,1431,-131,1365,0.0006103895000485181,0
45109,1.41785797439114,103.75478033541316,SUNGEI KADUT,823,1652,-829,1237,0.0005531515103003787,0
45099,1.41341731294698,103.75591307485898,SUNGEI KADUT,3356,8147,-4791,5751,0.0025716849925121084,0
45079,1.40959346067748,103.75588199006808,SUNGEI KADUT,24270,103488,-79218,63879,0.028564887086885926,10
45069,1.4069390779681,103.75626773948963,SUNGEI KADUT,104523,123027,-18504,113775,0.05087697096558253,18
45059,1.40340952558706,103.75620896675814,SUNGEI KADUT,30700,28907,1793,29803,0.013327061003623433,4
45049,1.39773638898124,103.75499277801016,SUNGEI KADUT,21674,22469,-795,22071,0.009869528685399885,3
45039,1.39585817355572,103.75427816224409,SUNGEI KADUT,3758,4101,-343,3929,0.001756937982190936,0
45029,1.39303959514259,103.75414864750223,SUNGEI KADUT,24505,25931,-1426,25218,0.011276778323973282,4
44999,1.391239722,103.7545111,SUNGEI KADUT,4772,3601,1171,4186,0.0018718611334821223,0
45019,1.38829923721056,103.75553944051408,BUKIT PANJANG,7739,4389,3350,6064,0.0007232440549135929,49
44069,1.38592018696626,103.75717769160771,BUKIT PANJANG,63065,39552,23513,51308,0.0061194271057893514,417
44059,1.38449631673384,103.75817595629141,CHOA CHU KANG,59598,33552,26046,46575,0.003935996430349131,755
44049,1.38103523807931,103.7608578414621,BUKIT PANJANG,53412,88159,-34747,70785,0.008442419265675903,575
44149,1.37798495709362,103.75776732086608,BUKIT BATOK,171192,139668,31524,155430,0.012506247893900544,968
44139,1.37680960030968,103.75536565517723,BUKIT BATOK,110481,64060,46421,87270,0.0070219407688393515,544
44159,1.37401429037273,103.7525923087755,BUKIT BATOK,115981,62304,53677,89142,0.007172566105372722,555
44169,1.37047453510829,103.75017065253876,BUKIT BATOK,17160,21286,-4126,19223,0.0015467258783018088,119
44179,1.36783174007175,103.74735822064176,TENGAH,7896,1521,6375,4708,0.025603097605011855,0
43679,1.36506686600259,103.74421935477038,TENGAH,68329,42859,25470,55594,0.30233190489656525,3
43779,1.36195561634293,103.74177024979922,BUKIT BATOK,9398,7188,2210,8293,0.0006672734593329294,51
43789,1.35915702140816,103.73950237742633,BUKIT BATOK,88791,74514,14277,81652,0.0065699038347343955,509
43759,1.35596765339105,103.73690126563862,BUKIT BATOK,94688,32102,62586,63395,0.005100904492271923,395
43769,1.35151426989451,103.73781565466237,BUKIT BATOK,17600,10954,6646,14277,0.001148759577824217,89
28289,1.34238972202327,103.73598888901057,JURONG EAST,128386,119389,8997,123887,0.012082232952925744,949
28089,1.34016358625469,103.73634638831608,JURONG EAST,39252,28133,11119,33692,0.003285853985082972,258
28079,1.33839906637569,103.7386009027093,JURONG EAST,62701,51463,11238,57082,0.005566992674121638,437
40321,1.35174487949103,103.73947152056856,BUKIT BATOK,34832,65722,-30890,50277,0.004045400665004424,313
40331,1.353303,103.740304,BUKIT BATOK,2445,20717,-18272,11581,0.0009318333452953882,72
40351,1.35499656917814,103.7410021897397,BUKIT BATOK,10304,63961,-53657,37132,0.00298772435692154,231
40361,1.35715418971956,103.74085618975258,BUKIT BATOK,110858,97033,13825,103945,0.008363648827970738,648
40311,1.35730456918268,103.73890781029746,BUKIT BATOK,34198,21488,12710,27843,0.002240310494176625,173
40359,1.35540218970451,103.74090581028908,BUKIT BATOK,128785,65797,62988,97291,0.00782825300035693,606
40339,1.35347432348291,103.74087652056193,BUKIT BATOK,82823,57160,25663,69991,0.005631633509245274,436
40329,1.35096917519706,103.73961904709157,BUKIT BATOK,49637,31310,18327,40473,0.0032565487422623477,252
46229,1.43013056874728,103.78706868583511,WOODLANDS,56258,35252,21006,45755,0.0018184897262981197,463
46339,1.43352632033198,103.78798319246935,WOODLANDS,12539,178458,-165919,95498,0.0037954787866248023,968
46639,1.43702205360453,103.78884919678751,WOODLANDS,894,107357,-106463,54125,0.0021511475562427215,548
46009,1.436874,103.786162,WOODLANDS,5597764,5023215,574549,5310489,0.21106042373771555,53847
46631,1.43689297551872,103.78915264291737,WOODLANDS,97953,11447,86506,54700,0.0021740003940226675,554
46331,1.43314769562187,103.78816378743082,WOODLANDS,154561,31623,122938,93092,0.0036998545645403683,943
46221,1.4309096816047,103.78759769642132,WOODLANDS,30083,30996,-913,30539,0.0012137440225421983,309
53331,1.36285472197724,103.83701277802122,BISHAN,14570,51920,-37350,33245,0.004362306730588555,380
53341,1.36355638900203,103.83394166697735,BISHAN,45299,128232,-82933,86765,0.011385036651511986,994
53351,1.36080972198475,103.83211750001261,BISHAN,40280,83172,-42892,61726,0.008099496022027648,707
53361,1.35929833296604,103.83032083300758,BISHAN,72881,85058,-12177,78969,0.010362069490384948,904
53369,1.35947344252352,103.8301455974542,BISHAN,72240,79117,-6877,75678,0.00993023458437301,867
53359,1.36125666702141,103.83196166697407,BISHAN,70970,32787,38183,51878,0.006807271727161169,594
53349,1.3637398272719,103.83379317461136,BISHAN,114096,32852,81244,73474,0.00964103247776398,841
53339,1.36312998205072,103.8367836110905,BISHAN,55750,10826,44924,33288,0.00436794905843982,381
65049,1.38993499998792,103.90187166698628,SENGKANG,72916,103272,-30356,88094,0.006808098773461816,833
65039,1.38732058981564,103.90185567950667,SENGKANG,69284,80632,-11348,74958,0.0057929196978358435,709
65029,1.38461500003195,103.90061583298267,SENGKANG,190333,141855,48478,166094,0.01283611094602773,1572
67219,1.38368835333684,103.89751366061326,SENGKANG,127871,83318,44553,105594,0.008160537401922116,999
67269,1.38605407647483,103.89513364231524,SENGKANG,35000,32529,2471,33764,0.002609356448647635,319
67339,1.38648038153055,103.89269086108794,SENGKANG,21531,9798,11733,15664,0.0012105484957829805,148
67299,1.38683575602542,103.88973216030708,SENGKANG,21721,11501,10220,16611,0.0012837347461345178,157
67309,1.38813799869207,103.88759103191384,SENGKANG,11513,9888,1625,10700,0.0008269196185442984,101
67329,1.39001974230515,103.88460168183559,SENGKANG,34063,23545,10518,28804,0.002226036700238315,272
67479,1.39198203746983,103.88019668070044,SENGKANG,87772,76088,11684,81930,0.006331731247414427,775
67489,1.39100245036434,103.87708498686095,SENGKANG,110513,121571,-11058,116042,0.008967981904216587,1098
67281,1.38925023527794,103.87298584005708,SENGKANG,19637,36987,-17350,28312,0.0021880138542267457,267
67651,1.389341,103.871222,SENGKANG,2246,3719,-1473,2982,0.00023045554228963533,28
67039,1.38831000001759,103.86800750000182,SERANGOON,20136,20042,94,20089,0.0020400942653741295,238
67029,1.38906690681702,103.86517736947857,SERANGOON,8957,23076,-14119,16016,0.0016264696975574722,190
67019,1.38976371710347,103.86253811109862,SERANGOON,15635,5032,10603,10333,0.0010493451164373976,122
55109,1.39049447273752,103.8599334800352,SERANGOON,19994,14897,5097,17445,0.0017715886534646669,207
55089,1.39129403706334,103.85630398734284,ANG MO KIO,38512,60668,-22156,49590,0.002942070402397986,477
55079,1.391952,103.853366,ANG MO KIO,19623,20450,-827,20036,0.0011886937403195413,192
55059,1.3920822654425,103.84909518015897,ANG MO KIO,76583,64173,12410,70378,0.0041753787211124315,677
55049,1.39110547694961,103.84659281119058,ANG MO KIO,41592,36622,4970,39107,0.0023201360602254093,376
55039,1.3891573228776,103.84383135324573,ANG MO KIO,44564,31964,12600,38264,0.0022701226432215475,368
55029,1.38565193733046,103.83917105055716,ANG MO KIO,36274,56948,-20674,46611,0.0027653325978256207,448
55019,1.382212,103.836047,ANG MO KIO,64415,91835,-27420,78125,0.004634991937635464,752
56039,1.37673055602474,103.82848388900504,ANG MO KIO,36650,20440,16210,28545,0.0016935148142054953,274
56029,1.37359500001635,103.82870000002058,ANG MO KIO,61752,36521,25231,49136,0.002915135537249999,473
56019,1.369486,103.828616,ANG MO KIO,25787,7495,18292,16641,0.0009872755306776545,160
56011,1.36865,103.828321,ANG MO KIO,8989,14737,-5748,11863,0.0007038068397589698,114
56021,1.372666,103.82843,ANG MO KIO,42199,76029,-33830,59114,0.0035071092915377002,569
56031,1.37695666700099,103.82822527799023,ANG MO KIO,17412,45746,-28334,31579,0.001873515653101956,304
55011,1.382262,103.835704,ANG MO KIO,36940,36373,567,36656,0.0021747233851643595,352
55021,1.3857011784032,103.83872706499656,ANG MO KIO,64622,34481,30141,49551,0.0029397566144227184,477
55031,1.38944774212221,103.84360331162512,ANG MO KIO,36626,47470,-10844,42048,0.002494619404719309,404
55041,1.39122406741106,103.84602799523668,ANG MO KIO,35772,40326,-4554,38049,0.002257367145409175,366
55051,1.3923998014128,103.8489623936009,ANG MO KIO,51936,66720,-14784,59328,0.0035198054614532714,571
55071,1.39246274085167,103.85261828242731,ANG MO KIO,16914,20713,-3799,18813,0.0011161357225310206,181
55081,1.39177133420779,103.8559732827973,ANG MO KIO,50127,31465,18662,40796,0.0024203408779235377,392
55101,1.3909401415525,103.85967918415774,SENGKANG,12807,19318,-6511,16062,0.0012413068143045348,152
67011,1.39009747909366,103.86263251348234,SENGKANG,14049,13513,536,13781,0.001065026099360652,130
67021,1.389306388988,103.86548666703128,SENGKANG,14769,12589,2180,13679,0.0010571433142119119,129
67659,1.38980594691547,103.87074360172006,SENGKANG,3935,3292,643,3613,0.00027922061512154674,34
67289,1.38966431065207,103.8732873820409,SENGKANG,30564,18192,12372,24378,0.00188398565054887,230
67481,1.39149794105559,103.87764586518084,SENGKANG,120443,142211,-21768,131327,0.010149240443417484,1243
67471,1.39218567915754,103.88018144124133,SENGKANG,52298,63040,-10742,57669,0.0044567876151244065,545
67321,1.39056792623455,103.88425489183726,SENGKANG,34356,37010,-2654,35683,0.0027576610045342244,337
67301,1.38888930138858,103.88694431255796,SENGKANG,16456,23812,-7356,20134,0.0015559999625954116,190
67291,1.38717956363215,103.88971793853818,SENGKANG,12121,16613,-4492,14367,0.001110313472862237,135
67331,1.38676807101072,103.89252149146469,SENGKANG,4881,17512,-12631,11196,0.0008652515933852304,105
67261,1.3865874133088,103.89464206866457,SENGKANG,42795,60398,-17603,51596,0.003987452769945011,488
67211,1.38393828115359,103.89765917692944,SENGKANG,74197,93904,-19707,84050,0.006495569526976475,795
65021,1.38403136207098,103.89961345545082,SENGKANG,91213,159352,-68139,125282,0.009682069500043626,1185
65031,1.38711144385727,103.90167760841291,SENGKANG,147475,104096,43379,125785,0.009720942450335942,1190
65041,1.38984412426173,103.90162265734195,SENGKANG,75730,86714,-10984,81222,0.00627701544461729,768
11261,1.31223168432152,103.79444621838488,QUEENSTOWN,143071,79499,63572,111285,0.009664276990327821,927
11271,1.31473444398294,103.79008416699845,BUKIT TIMAH,11228,21008,-9780,16118,0.002672755734203579,208
11281,1.31622694399746,103.78852194399074,BUKIT TIMAH,2537,6196,-3659,4366,0.0007239888035446598,56
11289,1.31618891387774,103.78904342517946,BUKIT TIMAH,7968,4441,3527,6204,0.0010287738289489394,80
11279,1.31466878886978,103.79069259768109,BUKIT TIMAH,18396,9408,8988,13902,0.002305289131213436,179
11269,1.31256112590195,103.79453796697418,BUKIT TIMAH,43400,52957,-9557,48178,0.007989082129449066,622
50019,1.31194891032358,103.84763856174139,KALLANG,46697,112106,-65409,79401,0.008063472745703817,413
05189,1.2820913960391,103.84528061446953,OUTRAM,38516,54971,-16455,46743,0.014946271697722262,136
05259,1.27979447837032,103.84262707605177,OUTRAM,11265,23848,-12583,17556,0.005613605158530947,51
05239,1.27854113014976,103.8415105424013,OUTRAM,18350,30595,-12245,24472,0.007825025372497683,71
10021,1.27744837946643,103.83838894560753,BUKIT MERAH,34401,46456,-12055,40428,0.00235597384885345,356
18119,1.30004638896912,103.78466749999943,QUEENSTOWN,61837,38079,23758,49958,0.004338481824889224,416
19089,1.30370305599194,103.78184388900041,QUEENSTOWN,158310,168868,-10558,163589,0.01420649151791111,1362
19091,1.30739277801307,103.78208222199827,QUEENSTOWN,34738,18053,16685,26395,0.002292210011768907,219
19099,1.30697118032996,103.78191236221397,QUEENSTOWN,15542,55213,-39671,35377,0.0030722301036692034,294
19071,1.30515500002931,103.78108305597279,QUEENSTOWN,130713,141087,-10374,135900,0.011801907202098673,1132
19081,1.30256972202724,103.78282472199413,QUEENSTOWN,149877,72127,77750,111002,0.009639700538979815,924
18111,1.30059305599352,103.78448416698873,QUEENSTOWN,65861,47162,18699,56511,0.004907561279601163,470
40011,1.30606411522588,103.84908751469008,ROCHOR,373553,227708,145845,300630,0.07755267560987313,506
40101,1.31036186651665,103.84779148902439,KALLANG,68101,99187,-31086,83644,0.008494365490883617,435
50011,1.31181999999518,103.84719777801662,KALLANG,53253,32692,20561,42972,0.004363969607793157,223
58151,1.44835904274406,103.82201343608213,SEMBAWANG,60281,18317,41964,39299,0.005182447907820236,531
58039,1.4467419,103.8258,SEMBAWANG,4198,4727,-529,4462,0.0005884140198145982,60
58029,1.44315919415772,103.82398509211036,SEMBAWANG,30948,48400,-17452,39674,0.005231900004958397,537
58019,1.44085,103.824719,SEMBAWANG,99873,140520,-40647,120196,0.015850518046982395,1626
57139,1.43795662145081,103.8255962797174,SEMBAWANG,25741,28331,-2590,27036,0.003565298395272854,365
57129,1.43418656873084,103.82641445936885,MANDAI,157100,174026,-16926,165563,0.5009910098011626,1047
57119,1.43130257113028,103.82688773076856,YISHUN,248890,491452,-242562,370171,0.018564398207347073,4114
57089,1.42740500891774,103.82685672676006,YISHUN,90204,138670,-48466,114437,0.005739115267414727,1271
57079,1.42443860227619,103.82566793061787,YISHUN,30178,59870,-29692,45024,0.0022579928327383686,500
57069,1.4189659270404,103.82460551333597,YISHUN,2939,1620,1319,2279,0.00011429383586111279,25
57059,1.41472777811863,103.82356549744377,YISHUN,11633,13908,-2275,12770,0.0006404266274446732,141
57049,1.41082027802703,103.82233527798766,YISHUN,433,886,-453,659,3.304942423539856e-05,7
57039,1.40611750000192,103.8199872220186,YISHUN,14869,21029,-6160,17949,0.0009001579902900891,199
57029,1.40396290628178,103.81862261343507,YISHUN,70889,54327,16562,62608,0.003139845754976985,695
05631,1.27346055934188,103.84034718190608,BUKIT MERAH,74329,44425,29904,59377,0.003460241892336284,523
05521,1.27676861098316,103.84059222200347,OUTRAM,63749,33160,30589,48454,0.01549337117517991,141
05519,1.27553472200739,103.84112694400494,OUTRAM,44095,104127,-60032,74111,0.02369730530325171,216
05629,1.273211389,103.84187,DOWNTOWN CORE,15548,26949,-11401,21248,0.004426108792537607,7
57021,1.40414074099185,103.81834244198308,YISHUN,60491,76698,-16207,68594,0.0034400488710211365,762
57031,1.40705411971506,103.82012256385369,YISHUN,13743,10575,3168,12159,0.0006097844450352217,135
57041,1.41069268256433,103.82192312004506,YISHUN,703,348,355,525,2.6329207471296275e-05,5
57051,1.415206,103.8233905,MANDAI,17104,15383,1721,16243,0.049151060153538435,102
57061,1.419905,103.8245465,YISHUN,7713,7949,-236,7831,0.0003927314737289926,87
57071,1.424958,103.8255225,YISHUN,74471,43929,30542,59200,0.002968931585334742,657
57081,1.42753611101756,103.82655472202663,YISHUN,22034,21064,970,21549,0.0010807011272361208,239
57111,1.43123622644607,103.82654938929034,YISHUN,207919,114218,93701,161068,0.008077700550450949,1790
57121,1.43345083292583,103.82631132424072,MANDAI,77779,42409,35370,60094,0.1818434900490512,380
57131,1.43808413802489,103.82529753316932,SEMBAWANG,29767,39429,-9662,34598,0.00456251641809625,468
58011,1.44135611418225,103.82418746836298,SEMBAWANG,139703,134479,5224,137091,0.01807849986338034,1855
58021,1.44324136994568,103.82367863032862,SEMBAWANG,25343,20549,4794,22946,0.0030259408558193117,310
58031,1.4462869,103.8250487,SEMBAWANG,1071,3549,-2478,2310,0.00030462491837107166,31
58159,1.44821708737482,103.82235611868522,SEMBAWANG,6623,8659,-2036,7641,0.0010076359312871683,103
84521,1.33230500002897,103.93393805556471,BEDOK,238075,77687,160388,157881,0.006429609639075489,862
84201,1.33660054449421,103.93309401156243,BEDOK,130929,358245,-227316,244587,0.009960659818423728,1336
75341,1.33832204097015,103.933861255669,BEDOK,141194,152349,-11155,146771,0.005977161509850765,802
75061,1.34071391760745,103.93646836281481,TAMPINES,10578,14096,-3518,12337,0.0005149280294480232,133
76541,1.360247,103.940633,TAMPINES,46095,132625,-86530,89360,0.00372975348232758,969
75281,1.36022789260467,103.93363809095122,TAMPINES,60757,102155,-41398,81456,0.003399852279056349,883
75289,1.36045667202312,103.93331674675824,TAMPINES,65512,44243,21269,54877,0.002290484353734228,595
76549,1.360559,103.940515,TAMPINES,131425,70261,61164,100843,0.004209036822049688,1093
75069,1.34066333296943,103.93669999999881,TAMPINES,15757,14409,1348,15083,0.0006295419849367378,163
75349,1.33811824869625,103.9339578151498,BEDOK,160089,156608,3481,158348,0.006448627935776475,865
84209,1.33702513693776,103.93333589306084,BEDOK,324701,115627,209074,220164,0.008966047697806677,1203
84529,1.33213305553955,103.93431305555218,BEDOK,115519,270855,-155336,193187,0.007867425449193232,1055
46271,1.44040195107982,103.78588806965098,WOODLANDS,37607,9385,28222,23496,0.0009338265677871407,238
46269,1.44217333334596,103.78588499999181,WOODLANDS,32641,191885,-159244,112263,0.004461788048156613,1138
46451,1.44454396366237,103.78920988459528,WOODLANDS,19150,28880,-9730,24015,0.0009544537378876482,243
46461,1.44659598354815,103.79359661898341,WOODLANDS,59823,74538,-14715,67180,0.0026700063340117514,681
46471,1.44796931841747,103.79758820990358,WOODLANDS,112490,144619,-32129,128554,0.005109258622544606,1303
46481,1.44964404178885,103.8011125258027,WOODLANDS,62884,71744,-8860,67314,0.002675332038816121,682
46721,1.45248916519346,103.80178758846797,SEMBAWANG,7415,18417,-11002,12916,0.0017032620976972993,174
46711,1.45470160187201,103.80084970775462,WOODLANDS,30051,67876,-37825,48963,0.0019459886890773649,496
47071,1.45761031985152,103.80214839695255,SEMBAWANG,48174,87026,-38852,67600,0.008914564710772486,914
47821,1.46077717684188,103.80582927631109,SEMBAWANG,29750,34493,-4743,32121,0.0042358688324663175,434
47811,1.46237692251291,103.80898707919847,SEMBAWANG,19819,21454,-1635,20636,0.0027213159374482403,279
47801,1.46417400978934,103.8129834777538,SEMBAWANG,72902,57773,15129,65337,0.008616137788576065,884
58141,1.463365158306,103.81653183057891,SEMBAWANG,38314,23256,15058,30785,0.004059687494395429,416
58161,1.46052755709037,103.82037350350512,SEMBAWANG,66677,16931,49746,41804,0.005512787916703152,565
58171,1.45890580814381,103.82379883168399,SEMBAWANG,14342,6211,8131,10276,0.001355119333844646,139
58181,1.45964275024639,103.82625715308492,SEMBAWANG,2067,1042,1025,1554,0.0002049294905405391,21
58191,1.45875202875202,103.82875514072087,SEMBAWANG,9517,2861,6656,6189,0.0008161574111682088,83
58201,1.45531234912714,103.83098996673239,SEMBAWANG,4668,1126,3542,2897,0.000382033934424673,39
58069,1.452187,103.830428,SEMBAWANG,38388,16499,21889,27443,0.0036189704047001384,371
58269,1.44702361616489,103.82761997468876,SEMBAWANG,10307,4996,5311,7651,0.0010089546538775192,103
59339,1.42273567302859,103.83378411194366,YISHUN,68149,98771,-30622,83460,0.004185591724865499,927
59549,1.42313912325939,103.83052605711299,YISHUN,5893,5425,468,5659,0.0002838037811048869,62
59559,1.42511776424343,103.82821308909149,YISHUN,12680,42135,-29455,27407,0.0013744849317444132,304
59551,1.42539008150192,103.82822466548578,YISHUN,71675,22649,49026,47162,0.002365215395735762,524
59541,1.42363018656288,103.83018072233915,YISHUN,5164,3208,1956,4186,0.00020993154757113563,46
59331,1.422973728077,103.83276716795122,YISHUN,68928,60893,8035,64910,0.0032552930608796974,721
58261,1.44710213838584,103.82726305553976,SEMBAWANG,5594,27656,-22062,16625,0.0021923763064584704,225
58061,1.45296423052616,103.83110625286093,SEMBAWANG,11027,24564,-13537,17795,0.0023466668495295325,240
58209,1.45524083298775,103.83062638903208,SEMBAWANG,635,10744,-10109,5689,0.0007502212816506609,77
58199,1.4590501574168,103.82788431875926,SEMBAWANG,1499,5167,-3668,3333,0.0004395302393639748,45
58189,1.45915444426655,103.82601182603965,SEMBAWANG,808,1385,-577,1096,0.00014453199590246517,14
58179,1.45855645310428,103.82350997035716,SEMBAWANG,3686,11055,-7369,7370,0.0009718985490886571,99
58169,1.45978696349073,103.82092447388442,SEMBAWANG,9066,70424,-61358,39745,0.005241262935349889,537
58149,1.46190359169667,103.81788921693168,SEMBAWANG,24051,42995,-18944,33523,0.0044207537396335215,453
47809,1.46379183832972,103.813587498325,SEMBAWANG,56351,79291,-22940,67821,0.008943708480019243,917
47819,1.4625580134543,103.81005089658552,SEMBAWANG,21728,27166,-5438,24447,0.003223881116630991,330
47829,1.46054631909982,103.80617388921056,SEMBAWANG,30715,29146,1569,29930,0.003946936712920422,405
47079,1.45786431264124,103.8029959994045,SEMBAWANG,83852,49642,34210,66747,0.00880207767381555,903
46719,1.45490953729339,103.80106314214777,SEMBAWANG,48686,26596,22090,37641,0.0049638037023400465,509
46729,1.4521571470745,103.80223070821165,WOODLANDS,15390,7581,7809,11485,0.00045646059461335167,116
46489,1.44952095631928,103.80160651744906,WOODLANDS,125511,103633,21878,114572,0.004553557095867734,1161
46479,1.44796869795143,103.79840963198184,WOODLANDS,128916,101278,27638,115097,0.004574422730362467,1167
46469,1.44668865905093,103.79491852510797,WOODLANDS,74089,56000,18089,65044,0.0025851130096674656,659
46459,1.4441853308513,103.78940895329838,WOODLANDS,36301,29094,7207,32697,0.0012995117163319772,331
46261,1.44256309213662,103.78694461350949,WOODLANDS,62199,59794,2405,60996,0.0024242290316966474,618
46279,1.44021958652464,103.78690125681027,WOODLANDS,135752,90842,44910,113297,0.004502883412094811,1148
78119,1.37568,103.957966,PASIR RIS,82762,113555,-30793,98158,0.009255659518309296,671
78221,1.37417517709229,103.96122560227602,PASIR RIS,81486,87267,-5781,84376,0.007956106761719525,577
78151,1.37239496316057,103.96078021168164,PASIR RIS,39209,27676,11533,33442,0.003153362595115013,228
78161,1.36900499745113,103.96052175997124,PASIR RIS,25048,39034,-13986,32041,0.003021257428086841,219
76099,1.35026359502623,103.95249172187374,TAMPINES,192072,136713,55359,164392,0.006861477556700935,1783
76089,1.34916805553714,103.94923388889873,TAMPINES,182126,149001,33125,165563,0.006910353354908249,1796
76079,1.34794388891649,103.94563500000055,TAMPINES,188347,138093,50254,163220,0.006812560019981061,1770
84439,1.33474732352614,103.95024017522437,TAMPINES,39767,31977,7790,35872,0.0014972439225386632,389
84599,1.33772607555094,103.94646797815965,TAMPINES,82029,25545,56484,53787,0.002244989375044243,583
84279,1.33664160677812,103.94439635871171,TAMPINES,28675,7025,21650,17850,0.0007450324491892044,193
84269,1.33402333297056,103.94185027798375,BEDOK,80518,37020,43498,58769,0.0023933325028269864,321
84259,1.33328807616427,103.93910677080204,BEDOK,60135,91818,-31683,75976,0.0030940773236703555,415
84349,1.33091748609947,103.93233223449336,BEDOK,73436,97372,-23936,85404,0.003478027005248276,466
84329,1.33029323198176,103.92970061275057,BEDOK,35103,35767,-664,35435,0.0014430692582428535,193
84319,1.32980564460578,103.92771515822335,BEDOK,33025,49865,-16840,41445,0.0016878229267073533,226
84309,1.32802803259661,103.92687404688121,BEDOK,47915,100362,-52447,74138,0.0030192258689885334,405
84301,1.32782140214678,103.92656628872025,BEDOK,113200,47088,66112,80144,0.0032638166398367505,438
84311,1.32999872121867,103.92731666563313,BEDOK,64889,49539,15350,57214,0.0023300060544971532,312
84321,1.33060063600662,103.92977387914273,BEDOK,35830,39820,-3990,37825,0.0015404005839716646,206
84341,1.33110349338955,103.93198370934411,BEDOK,62984,53814,9170,58399,0.0023782644733208523,319
84251,1.33346832060545,103.93883800719165,BEDOK,81433,70634,10799,76033,0.003096398614702381,415
84261,1.334189,103.941658,BEDOK,50415,79248,-28833,64831,0.002640203840303159,354
84271,1.336735,103.94411,TAMPINES,9245,30965,-21720,20105,0.0008391527950111458,218
84591,1.33774805557922,103.94699472223161,TAMPINES,29540,83653,-54113,56596,0.0023622328568242133,613
84431,1.33513644378005,103.9502227306511,TAMPINES,30016,32313,-2297,31164,0.0013007390054079757,338
76071,1.34802638899143,103.94517805600674,TAMPINES,165813,241858,-76045,203835,0.008507769707589999,2211
76081,1.34950194446778,103.94932305553937,TAMPINES,171090,201443,-30353,186266,0.007774465780430047,2020
76091,1.35071636446812,103.95275166965992,TAMPINES,130523,119701,10822,125112,0.005221988783359089,1357
78169,1.36906973013181,103.96024801184656,PASIR RIS,63463,64788,-1325,64125,0.0060465694758611984,438
78159,1.37246473904375,103.96053778303401,PASIR RIS,55047,63931,-8884,59489,0.005609424897458196,406
78229,1.37411139885456,103.96093853137384,PASIR RIS,62490,68040,-5550,65265,0.006154064044320954,446
78111,1.37545781179514,103.95798631897796,PASIR RIS,152600,96531,56069,124565,0.011745667473850295,852
01109,1.30358577565355,103.85650372998224,ROCHOR,8146,11916,-3770,10031,0.002587668858871827,16
07551,1.30171975809706,103.8546132267025,DOWNTOWN CORE,283315,105206,178109,194260,0.04046573296490755,64
07531,1.30365644370093,103.8525732326128,ROCHOR,236395,239282,-2887,237838,0.061354399965741956,400
40271,1.30880664936794,103.8463464537845,NEWTON,20595,11362,9233,15978,0.019563452659211708,84
40021,1.311033889,103.8427911,NEWTON,19684,35234,-15550,27459,0.03362078148512294,144
40031,1.31178509472011,103.84098359641321,NEWTON,28255,45077,-16822,36666,0.04489382621120644,193
40041,1.3137222313328,103.83809742560602,NEWTON,155216,43929,111287,99572,0.12191589111171787,525
40051,1.31588,103.83632,NEWTON,57879,116425,-58546,87152,0.10670885130527091,459
40111,1.31806499998598,103.83262555597635,TANGLIN,53327,48124,5203,50725,0.02538904424575894,256
40071,1.31918027796911,103.829213610999,TANGLIN,29157,29312,-155,29234,0.014632298067629708,147
40081,1.32012951912406,103.82605259642706,TANGLIN,70140,52711,17429,61425,0.030744643524805184,310
42091,1.34278636864291,103.77539033846315,BUKIT TIMAH,237921,176328,61593,207124,0.034346188031466815,2674
42111,1.34584805601375,103.77262861101015,BUKIT PANJANG,27800,46357,-18557,37078,0.004422236653708146,301
43011,1.34742333297015,103.77118138899144,BUKIT TIMAH,17599,36776,-19177,27187,0.004508264682081692,351
43021,1.35132007773328,103.76979529427526,BUKIT PANJANG,14710,30911,-16201,22810,0.00272051399943586,185
43041,1.35582940983395,103.76845331635313,BUKIT BATOK,41744,54891,-13147,48317,0.0038876946502579457,301
43051,1.35910148170791,103.76705036241354,BUKIT BATOK,31224,36439,-5215,33831,0.0027221184616775993,210
43061,1.36301133873589,103.76739148459211,BUKIT BATOK,97221,128977,-31756,113099,0.009100200286638728,705
43071,1.36511351504744,103.76698012950051,BUKIT BATOK,2654,5833,-3179,4243,0.00034140133702515607,26
43081,1.36704277799302,103.76572777796798,BUKIT BATOK,33325,22896,10429,28110,0.0022617939155732117,175
43091,1.36863253283887,103.76474109358477,BUKIT PANJANG,14759,15112,-353,14935,0.001781274729573633,121
43111,1.37229972154626,103.76298146518725,BUKIT BATOK,24508,12114,12394,18311,0.0014733443040932436,114
44011,1.37448606693865,103.76257120089846,BUKIT PANJANG,6195,9048,-2853,7621,0.0009089450762692104,61
44021,1.37820722702851,103.76172178111382,BUKIT PANJANG,218451,145318,73133,181884,0.021693027982174134,1478
46021,1.42919861102901,103.76175138901188,SUNGEI KADUT,1018,3472,-2454,2245,0.0010039006795669768,0
46031,1.4335562926407,103.7619231548512,SUNGEI KADUT,3188,22866,-19678,13027,0.005825306972257909,2
46041,1.43664137008987,103.76405579624996,SUNGEI KADUT,2037,13784,-11747,7910,0.003537128897717054,1
46051,1.43897086088179,103.76640888181257,SUNGEI KADUT,11106,16444,-5338,13775,0.006159791474848599,2
46069,1.44288948418349,103.76933833799299,WOODLANDS,749657,649969,99688,699813,0.027813413852690767,7096
46088,1.44180914262822,103.77108660594439,WOODLANDS,146653,142963,3690,144808,0.005755258666501543,1468
46091,1.43960616363191,103.77010864564294,WOODLANDS,1766,713,1053,1239,4.924289740757011e-05,12
44029,1.37863409952448,103.7621954983533,BUKIT PANJANG,364395,476681,-112286,420538,0.050156927500866186,3418
44019,1.37651095528157,103.7625299525816,BUKIT PANJANG,14794,7431,7363,11112,0.0013253113354551197,90
43119,1.37337830995776,103.76300821940876,BUKIT PANJANG,23281,39399,-16118,31340,0.003737874122854882,254
43109,1.37043731031208,103.76391083181434,BUKIT PANJANG,28055,31081,-3026,29568,0.0035265303785760416,240
43099,1.36872205121157,103.76498636840047,BUKIT PANJANG,39389,47498,-8109,43443,0.005181380520714251,353
43089,1.36705664197789,103.76608527288596,BUKIT BATOK,43665,47220,-3555,45442,0.0036563656745456376,283
43069,1.36296778241046,103.76768583722071,BUKIT PANJANG,105520,152360,-46840,128940,0.015378477645210864,1048
43059,1.359408611,103.7674364,BUKIT BATOK,28124,30919,-2795,29521,0.0023753261537401912,184
43049,1.3556996199834,103.76885141403912,BUKIT PANJANG,33564,19470,14094,26517,0.0031626422500237047,215
43029,1.35218580086883,103.77000849173528,BUKIT PANJANG,22614,11870,10744,17242,0.002056427109963748,140
43019,1.348201944,103.7710775,BUKIT PANJANG,64583,45185,19398,54884,0.006545931185665837,446
42119,1.34582513057916,103.77330275765884,BUKIT PANJANG,43850,35720,8130,39785,0.004745096425583327,323
42099,1.34160317659437,103.77579384383286,BUKIT TIMAH,112573,167234,-54661,139903,0.0231993141507807,1806
42079,1.339255,103.776989,BUKIT TIMAH,35986,49553,-13567,42769,0.007092138602565633,552
40089,1.320510556,103.8273903,NOVENA,28145,16575,11570,22360,0.0038623777460711187,190
40079,1.3197216415795,103.8299145659947,NOVENA,11566,9037,2529,10301,0.0017793538981341053,87
40119,1.31889734253426,103.83249521257974,NOVENA,23317,17625,5692,20471,0.0035360793756628746,174
40069,1.31830398893217,103.83435129198834,NOVENA,89778,54000,35778,71889,0.012417820831274896,612
40059,1.31662138896806,103.83634361100417,NEWTON,21690,9851,11839,15770,0.01930877759643063,83
40049,1.31402305600959,103.83884638900086,NOVENA,22723,57933,-35210,40328,0.006966098825740433,343
40039,1.31230305602353,103.8407255559936,NOVENA,48363,23856,24507,36109,0.006237325493420484,307
40029,1.31142305600915,103.84265999998345,NOVENA,17327,7492,9835,12409,0.002143481460241347,105
40279,1.30981925741503,103.8460393043403,KALLANG,66534,34211,32323,50372,0.0051154676785757445,262
59141,1.43034383196416,103.83275541050214,YISHUN,160544,61004,99540,110774,0.00555541262557214,1231
59111,1.43016395103424,103.82888452126694,YISHUN,413606,453781,-40175,433693,0.0217500818587598,4820
48149,1.41521080481899,103.80907903666171,YISHUN,3847,9260,-5413,6553,0.0003286386601131514,72
48019,1.41047890324886,103.77547240613428,CENTRAL WATER CATCHMENT,11701,9637,2064,10669,0.022850766439851018,0
44269,1.37577833299245,103.77422500002575,BUKIT PANJANG,338728,421651,-82923,380189,0.04534456365328892,3090
44229,1.37656055754166,103.771459794786,BUKIT PANJANG,304357,210437,93920,257397,0.03069934861520351,2092
44219,1.37578333297826,103.769352222019,BUKIT PANJANG,74062,70191,3871,72126,0.008602358295629586,586
44209,1.37719530827914,103.76698269593902,BUKIT PANJANG,62365,106782,-44417,84573,0.01008689305016611,687
44731,1.37887883000016,103.76432732997739,BUKIT PANJANG,27426,176235,-148809,101830,0.01214510918731055,827
44909,1.37998945869065,103.76225836886368,BUKIT PANJANG,10228,11673,-1445,10950,0.0013059898419036681,89
44201,1.37732275970527,103.7672668951858,BUKIT PANJANG,122400,59640,62760,91020,0.010855816932426654,739
44211,1.37610015820197,103.76921822286211,BUKIT PANJANG,59741,57248,2493,58494,0.006976490393818553,475
44221,1.3762995851872,103.77099428887409,BUKIT PANJANG,206761,295103,-88342,250932,0.02992827790032614,2039
44261,1.3760822219899,103.774277778025,BUKIT PANJANG,413052,335717,77335,374384,0.0446522101343619,3043
48011,1.41053605692452,103.77449402303927,MANDAI,11204,11899,-695,11551,0.034953142635813735,73
48141,1.41557085636805,103.8094962642582,MANDAI,8410,2906,5504,5658,0.01712101818313861,35
59119,1.43037444021889,103.82794865433573,YISHUN,321750,223401,98349,272575,0.013669873764740156,3029
59149,1.43061861098729,103.83218000002928,YISHUN,94263,105620,-11357,99941,0.0050121282359787064,1110
44009,1.38586897797184,103.74578895932125,CHOA CHU KANG,2264903,2399981,-135078,2332442,0.19711182793336313,37859
44539,1.38463078337388,103.74502387945829,CHOA CHU KANG,800843,284478,516365,542660,0.04585953457634481,8808
44399,1.38306278590518,103.74851002579776,CHOA CHU KANG,101165,92331,8834,96748,0.008176055451281111,1570
44111,1.38094121398036,103.74975224203959,CHOA CHU KANG,80775,31915,48860,56345,0.004761647211337022,914
44109,1.3771776806334,103.74762171258732,CHOA CHU KANG,28144,45422,-17278,36783,0.003108486456200367,597
44099,1.37631844004137,103.74462947882313,CHOA CHU KANG,123335,155862,-32527,139598,0.01179725667598235,2265
44089,1.37648110284286,103.74094532328145,CHOA CHU KANG,67018,51831,15187,59424,0.005021849745079265,964
44689,1.37811000397911,103.73849893266107,CHOA CHU KANG,195263,137452,57811,166357,0.014058627121064742,2700
44079,1.37657500784909,103.73634658951725,CHOA CHU KANG,97680,57817,39863,77748,0.006570388630526769,1261
30089,1.377159999987,103.73409166698833,TENGAH,8203,12844,-4641,10523,0.05722629483805008,0
30099,1.37972159795466,103.73122812228895,WESTERN WATER CATCHMENT,3370,11258,-7888,7314,0.005140853336669663,1
30059,1.37439935176831,103.72614304198139,WESTERN WATER CATCHMENT,374,2853,-2479,1613,0.0011337430177807174,0
30049,1.37431332163268,103.723836557791,WESTERN WATER CATCHMENT,7461,41873,-34412,24667,0.017337903917915037,5
30039,1.37432162221947,103.71981883880738,WESTERN WATER CATCHMENT,13559,150757,-137198,82158,0.0577470916644936,16
30029,1.37415602765485,103.71709630730658,WESTERN WATER CATCHMENT,24828,18661,6167,21744,0.015283390067342788,4
30019,1.37333306785344,103.71365844785454,WESTERN WATER CATCHMENT,8148,31217,-23069,19682,0.01383405460381902,4
31199,1.37097558139998,103.70931539839594,WESTERN WATER CATCHMENT,196,235,-39,215,0.00015111887713754136,0
31179,1.37234403223499,103.70355081890855,WESTERN WATER CATCHMENT,699,890,-191,794,0.0005580855276614318,0
31169,1.37245094201191,103.7012193702135,WESTERN WATER CATCHMENT,209,792,-583,500,0.00035143924915707295,0
31159,1.37336600723318,103.69619726943306,WESTERN WATER CATCHMENT,20693,9934,10759,15313,0.010763178444684517,3
31059,1.37207574401713,103.69466807265977,WESTERN WATER CATCHMENT,9643,4338,5305,6990,0.00491312070321588,1
31049,1.36939554385137,103.6942436921991,WESTERN WATER CATCHMENT,3004,1610,1394,2307,0.0016215406956107347,0
31039,1.36563783980926,103.69330818055283,WESTERN WATER CATCHMENT,19397,16499,2898,17948,0.012615263287742292,3
31029,1.36307987152083,103.69296604646463,WESTERN WATER CATCHMENT,964,741,223,852,0.0005988524805636523,0
31019,1.35998260495758,103.69398905356208,WESTERN WATER CATCHMENT,189,312,-123,250,0.00017571962457853648,0
27129,1.35733217246828,103.69516041986128,WESTERN WATER CATCHMENT,4811,13226,-8415,9018,0.006338558297796968,1
27109,1.35309472199852,103.70082305601869,JURONG WEST,89792,113079,-23287,101435,0.004167203991609145,545
27099,1.35023689448473,103.70360999821403,JURONG WEST,129304,75680,53624,102492,0.004210628200404244,550
22491,1.336702,103.705146,JURONG WEST,12378,114965,-102587,63671,0.0026157642367008018,342
22499,1.337665,103.704915,JURONG WEST,165263,100873,64390,133068,0.005466766902503531,715
27091,1.34910999998031,103.70388500000492,JURONG WEST,62783,118436,-55653,90609,0.003722444782133514,487
27101,1.35259472200365,103.70111638902962,JURONG WEST,118394,81977,36417,100185,0.004115850859164609,538
27121,1.35682305601032,103.69521277798744,WESTERN WATER CATCHMENT,13656,2997,10659,8326,0.005852166376963579,1
31011,1.35908460846532,103.69389522616177,WESTERN WATER CATCHMENT,2904,107,2797,1505,0.0010578321399627897,0
31021,1.36247047014576,103.69287888535482,WESTERN WATER CATCHMENT,585,1440,-855,1012,0.0007113130402939156,0
31031,1.36598890667515,103.69327324255713,WESTERN WATER CATCHMENT,20358,18862,1496,19610,0.013783447351940401,3
31041,1.36893226400594,103.6939293999916,WESTERN WATER CATCHMENT,1570,3400,-1830,2485,0.0017466530683106526,0
31051,1.37226002154624,103.69445182104045,WESTERN WATER CATCHMENT,4575,10228,-5653,7401,0.005202003766022994,1
31151,1.37363227377286,103.69596747862987,WESTERN WATER CATCHMENT,9975,19165,-9190,14570,0.010240939720437107,2
31161,1.37253332216297,103.70208763060677,WESTERN WATER CATCHMENT,1572,1065,507,1318,0.0009263938607780443,0
31171,1.37240788349149,103.70418696765007,WESTERN WATER CATCHMENT,319,117,202,218,0.0001532275126324838,0
31191,1.37161444444711,103.70991083335727,WESTERN WATER CATCHMENT,290,295,-5,292,0.00020524052150773062,0
30011,1.37367799480239,103.71422567942253,WESTERN WATER CATCHMENT,33139,11570,21569,22354,0.015712145951314416,4
30021,1.3744419562273,103.71705234322658,WESTERN WATER CATCHMENT,30794,44207,-13413,37500,0.02635794368678047,7
30031,1.37461935383489,103.71983865916742,WESTERN WATER CATCHMENT,89046,8260,80786,48653,0.034197147578478145,9
30041,1.37462014104762,103.72188815233464,WESTERN WATER CATCHMENT,39424,5456,33968,22440,0.015772593502169436,4
30051,1.37455576936144,103.72537054756133,WESTERN WATER CATCHMENT,4278,505,3773,2391,0.001680582489469123,0
30091,1.37943055556701,103.7308563889232,WESTERN WATER CATCHMENT,13045,2196,10849,7620,0.005355934157153792,1
30081,1.37727684686882,103.73431312110678,TENGAH,11377,8475,2902,9926,0.053979682843531794,0
44071,1.37677726111171,103.73622221734738,CHOA CHU KANG,71436,97659,-26223,84547,0.007144963826016704,1372
45451,1.3779238888638,103.73970805552322,CHOA CHU KANG,50219,104736,-54517,77477,0.006547486751136009,1257
44081,1.3767974760485,103.74072974268672,CHOA CHU KANG,28351,28085,266,28218,0.0023846687551603175,458
44091,1.37647222708666,103.74421611501322,CHOA CHU KANG,137982,125318,12664,131650,0.011125580892226797,2136
44101,1.37715950047084,103.74683070774694,CHOA CHU KANG,16670,19488,-2818,18079,0.0015278342343377764,293
44119,1.38048445565999,103.74930565785152,CHOA CHU KANG,25516,80343,-54827,52929,0.004472965218721399,859
44391,1.38288970873929,103.74831030292964,CHOA CHU KANG,52436,96937,-44501,74686,0.006311622746045201,1212
43399,1.35066714575721,103.74808875836682,BUKIT BATOK,18385,1479,16906,9932,0.0007991510910520503,61
43389,1.34760499094973,103.74834299093746,BUKIT BATOK,152171,17352,134819,84761,0.006820060977513375,528
43519,1.34527424103226,103.74835776931137,BUKIT BATOK,81708,54473,27235,68090,0.005478674767391675,424
43749,1.34661217154358,103.75163638787585,BUKIT BATOK,14032,7186,6846,10609,0.0008536240359415226,66
43739,1.34646078257571,103.75454805492608,BUKIT BATOK,15197,33421,-18224,24309,0.0019559568941184347,151
43169,1.34931074950483,103.7578877455261,BUKIT BATOK,102289,90578,11711,96433,0.007759216387779135,601
43231,1.35393625714127,103.76006304222618,BUKIT BATOK,42873,54441,-11568,48657,0.003915051816081315,303
43241,1.35584392851879,103.76188709548238,BUKIT BATOK,50302,49540,762,49921,0.004016756103142309,311
43291,1.35796167034005,103.7613803711349,BUKIT BATOK,6935,14974,-8039,10954,0.0008813835130269996,68
43301,1.35900254167529,103.76206438472947,BUKIT BATOK,6457,9994,-3537,8225,0.0006618020261682556,51
43261,1.3614550000211,103.76436750000349,BUKIT BATOK,25228,53881,-28653,39554,0.0031826039322868306,246
43811,1.35839109999144,103.76492799419663,BUKIT BATOK,50962,36789,14173,43875,0.003530281325000877,273
43821,1.35675369196927,103.7675828524089,BUKIT BATOK,22983,20671,2312,21827,0.0017562495836078438,136
42239,1.34027047980738,103.77016055707928,BUKIT TIMAH,21531,26936,-5405,24233,0.0040184197609477185,312
42309,1.3380616700805,103.76890878569641,BUKIT TIMAH,9737,28274,-18537,19005,0.0031514904286225973,245
42249,1.33696603683043,103.76697148211271,BUKIT TIMAH,12102,24201,-12099,18151,0.003009876494076757,234
42291,1.33769605916429,103.76430234507968,BUKIT BATOK,5586,4985,601,5285,0.0004252430040485387,32
42209,1.33914661405948,103.76363595867413,BUKIT BATOK,8657,4227,4430,6442,0.0005183378301004137,40
42201,1.33939353535638,103.76383096590918,BUKIT BATOK,4598,12298,-7700,8448,0.0006797451084582885,52
42299,1.3373703046187,103.76447557607713,BUKIT BATOK,4763,6471,-1708,5617,0.00045195647185253393,35
42241,1.33711750136148,103.76708487597254,BUKIT TIMAH,25249,14844,10405,20046,0.003324113503402714,258
42301,1.33874676722579,103.76866950533451,BUKIT TIMAH,21366,10064,11302,15715,0.002605928549634523,202
42231,1.34056805598593,103.7706058329681,BUKIT TIMAH,20413,29053,-8640,24733,0.00410133190061156,319
43829,1.35685805598526,103.767370833003,BUKIT BATOK,7934,21427,-13493,14680,0.001181185865550151,91
43819,1.35815575609947,103.76512620416916,BUKIT BATOK,8274,34513,-26239,21393,0.0017213289660568379,133
43267,1.36131333302001,103.76453111102046,BUKIT BATOK,9877,6667,3210,8272,0.0006655837520320742,51
43309,1.35871024095534,103.7619941010074,BUKIT BATOK,6820,10426,-3606,8623,0.0006938260026320812,53
43289,1.35736881542526,103.76144116190218,BUKIT BATOK,8557,7457,1100,8007,0.000644261255140331,49
43249,1.35565052307818,103.76204709426311,BUKIT BATOK,43472,21519,21953,32495,0.002614620892442245,202
43239,1.35308576389352,103.76002837789773,BUKIT BATOK,48087,37428,10659,42757,0.0034403245267934472,266
43161,1.34883190699072,103.75766163401367,BUKIT BATOK,104821,87125,17696,95973,0.007722203751665166,598
43731,1.34630310628015,103.75421605015862,BUKIT BATOK,35197,16610,18587,25903,0.0020842137244785806,161
43741,1.34650419288551,103.75185667801935,BUKIT BATOK,10004,14015,-4011,12009,0.000966271189331864,74
43511,1.34497394208663,103.74849870531534,BUKIT BATOK,51415,91317,-39902,71366,0.005742269106325073,444
43381,1.34696555762849,103.74766049075139,BUKIT BATOK,21871,132178,-110307,77024,0.006197524530526896,480
43391,1.34989395166691,103.7477975366473,BUKIT BATOK,4500,35365,-30865,19932,0.0016037736152687745,124
21399,1.3448140795943,103.70805985100185,JURONG WEST,119212,116356,2856,117784,0.00483886188147771,633
21421,1.34720307776277,103.71032595632526,JURONG WEST,258210,232631,25579,245420,0.010082468611630268,1319
21241,1.34973665190679,103.71235425312759,JURONG WEST,79632,65134,14498,72383,0.002973675028586235,389
06031,1.28607055552165,103.83879166662209,OUTRAM,33716,29569,4147,31642,0.010117663159389167,92
06039,1.28705997883119,103.83962555611693,OUTRAM,41577,43932,-2355,42754,0.013670772097734797,124
43452,1.348526111,103.7385769,BUKIT BATOK,9841,4222,5619,7031,0.0005657300967767787,43
21249,1.34958421982025,103.71249318123603,JURONG WEST,52821,77955,-25134,65388,0.0026863028994266154,351
21429,1.34740203306581,103.71059149459593,JURONG WEST,212258,230031,-17773,221144,0.009085149697051438,1188
21391,1.34485064221938,103.70847936082643,JURONG WEST,61544,84025,-22481,72784,0.0029901491134744418,391
17259,1.31092798217655,103.76746074010758,CLEMENTI,93568,43854,49714,68711,0.006396805646907239,279
17369,1.29840583296856,103.76386861099263,CLEMENTI,27088,37332,-10244,32210,0.002998662657898767,130
17309,1.29537083302023,103.7652455560114,QUEENSTOWN,6168,12507,-6339,9337,0.0008108492093156387,77
17359,1.29333722200355,103.76621750002619,QUEENSTOWN,2953,2107,846,2530,0.00021971173819948227,21
17299,1.29060555603074,103.77005055601747,QUEENSTOWN,2234,1817,417,2025,0.0001758562331438544,16
16249,1.28928277099215,103.77400682988979,QUEENSTOWN,1944,4984,-3040,3464,0.0003008227119063267,28
16239,1.28643527800393,103.77893444397212,QUEENSTOWN,17392,43626,-26234,30509,0.0026494804034498044,254
16229,1.2830090731877,103.78159959377587,QUEENSTOWN,11194,92388,-81194,51791,0.004497664281853513,431
16219,1.28015833301245,103.78362361100768,QUEENSTOWN,199,1573,-1374,886,7.694252966195309e-05,7
14369,1.28153635758335,103.80365927155157,BUKIT MERAH,29683,47308,-17625,38495,0.002243326736707568,339
14219,1.28218647936578,103.80684961252827,BUKIT MERAH,29013,66435,-37422,47724,0.002781154050724301,420
14209,1.28176397706369,103.80958869712056,BUKIT MERAH,53581,79798,-26217,66689,0.0038863545069305365,587
14199,1.28131676735406,103.81275056370772,BUKIT MERAH,75944,54059,21885,65001,0.003787984964611732,572
14191,1.28121833300943,103.81211444400743,BUKIT MERAH,69142,80395,-11253,74768,0.004357164656452824,659
14201,1.28167307267242,103.80914683892263,BUKIT MERAH,80750,65893,14857,73321,0.0042728395807802464,646
14471,1.28201169102423,103.80664978771298,BUKIT MERAH,49502,24290,25212,36896,0.0021501437401626813,325
14211,1.28161168409316,103.80521877469815,BUKIT MERAH,27548,19393,8155,23470,0.0013677329136388262,206
15211,1.27792442096507,103.78642808592167,QUEENSTOWN,2554,3286,-732,2920,0.0002535803460642246,24
16211,1.27941861098854,103.78357583299086,QUEENSTOWN,209,416,-207,312,2.7094886291793864e-05,2
16221,1.28297585453544,103.78118424868649,QUEENSTOWN,32759,9147,23612,20953,0.0018196126681793486,174
16231,1.28635947284714,103.77852933168337,QUEENSTOWN,41309,18303,23006,29806,0.0025884300667089995,248
16241,1.28910305603308,103.77352611096799,QUEENSTOWN,6691,2209,4482,4450,0.0003864494999951368,37
17291,1.29035140506061,103.7696982607242,QUEENSTOWN,1371,2560,-1189,1965,0.00017064567808774018,16
17351,1.29358000003179,103.76576444402885,CLEMENTI,5087,6139,-1052,5613,0.0005225549052712133,22
17301,1.29495361097608,103.76516694401265,QUEENSTOWN,12173,4740,7433,8456,0.0007343408925750285,70
17081,1.299503055534,103.76457888891022,CLEMENTI,17405,5306,12099,11355,0.001057119356735191,46
17251,1.31148,103.76744,CLEMENTI,8598,61276,-52678,34937,0.0032525388785783677,141
45009,1.37812611932206,103.763286611367,BUKIT PANJANG,1477223,733364,743859,1105293,0.13182661464175624,8983
44259,1.38029564329691,103.76297124601712,BUKIT PANJANG,597208,376599,220609,486903,0.058072180090632114,3957
43279,1.36203855984679,103.76591020179649,BUKIT BATOK,151636,31903,119733,91769,0.007383940442484456,572
43268,1.36036935442362,103.76427530511685,BUKIT BATOK,53645,37648,15997,45646,0.003672779974039659,284
43259,1.35757277797812,103.76266305599302,BUKIT BATOK,63941,66927,-2986,65434,0.005264967024959713,407
43449,1.35150377570255,103.7590516971924,BUKIT BATOK,90145,42397,47748,66271,0.0053323139302366524,413
43439,1.35118101224765,103.75622664327469,BUKIT BATOK,61714,43191,18523,52452,0.004220406064021561,326
43429,1.35108692530475,103.75389074656302,BUKIT BATOK,108669,94465,14204,101567,0.008172309591712001,633
43321,1.34990599565613,103.74510884287126,BUKIT BATOK,79390,78510,880,78950,0.006352494828691037,492
43371,1.34682313984594,103.74590277613717,BUKIT BATOK,118491,70058,48433,94274,0.007585498384800745,587
43699,1.34475341160997,103.74628307427523,BUKIT BATOK,138149,73015,65134,105582,0.008495365535185017,658
28629,1.34195331167525,103.74424995812674,JURONG EAST,80847,114195,-33348,97521,0.009510856181861465,747
17339,1.30785722199073,103.75850472198644,CLEMENTI,19046,29517,-10471,24281,0.0022604945047016442,98
17329,1.30505055600585,103.76058388902574,CLEMENTI,31386,24321,7065,27853,0.0025930379078067172,113
17319,1.30183915639239,103.76229972130764,CLEMENTI,27446,17847,9599,22646,0.0021082804890026536,91
17361,1.29859750001329,103.76346250000067,QUEENSTOWN,10760,10366,394,10563,0.0009173182176289056,87
17311,1.30101698629873,103.76229444678326,QUEENSTOWN,9272,14064,-4792,11668,0.0010132792732456756,97
17321,1.30483416696998,103.76035361097789,CLEMENTI,18600,21368,-2768,19984,0.0018604555900480894,81
17331,1.30758833300768,103.75833111102287,CLEMENTI,22837,11316,11521,17076,0.0015897287657956952,69
20151,1.31829668687275,103.74631047251557,JURONG EAST,30709,11368,19341,21038,0.0020517569790506817,161
20251,1.31975500989852,103.74447102076279,JURONG EAST,16719,19269,-2550,17994,0.0017548871128927638,137
28621,1.34154348249683,103.74358012428006,JURONG EAST,124156,116800,7356,120478,0.011749766010175302,923
43691,1.34490189049397,103.74605567060456,BUKIT BATOK,61467,130555,-69088,96011,0.00772526131725719,598
43379,1.34716553724092,103.74518662694207,BUKIT BATOK,73854,149497,-75643,111675,0.008985622039190266,696
43329,1.34976204246765,103.74483998148368,BUKIT BATOK,84141,69893,14248,77017,0.006196961294759944,480
43421,1.35109278850869,103.75362047618977,BUKIT BATOK,116734,112305,4429,114519,0.009214456685077503,713
43431,1.35138376789986,103.75644264494997,BUKIT BATOK,45683,46506,-823,46094,0.003708827063124568,287
43441,1.35173000550557,103.75897289147882,BUKIT BATOK,39595,70986,-31391,55290,0.004448757936394268,344
43251,1.35859534411792,103.76319656643706,BUKIT BATOK,50574,54204,-3630,52389,0.004215336942118996,326
43271,1.36222569232805,103.76588123664067,BUKIT BATOK,10695,140489,-129794,75592,0.006082302585059061,471
44251,1.38030076722264,103.76231669235113,BUKIT PANJANG,232891,426302,-193411,329596,0.039310413509779124,2679
43151,1.36363608446232,103.76489101192684,BUKIT BATOK,880,2930,-2050,1905,0.00015328059086328595,11
43719,1.36903972225026,103.76123388888554,BUKIT BATOK,16585,25195,-8610,20890,0.0016808564530887368,130
44739,1.37876549999936,103.76459849996492,BUKIT PANJANG,123082,39891,83191,81486,0.009718711256380118,662
44859,1.37763753804628,103.76321805626448,BUKIT PANJANG,5520,495,5025,3007,0.0003586403154889799,24
43721,1.37076302526768,103.7626491371365,BUKIT BATOK,2580,1535,1045,2057,0.00016551085323138014,12
43159,1.36439838852488,103.76517947881914,BUKIT BATOK,4050,550,3500,2300,0.00018506318056984655,14
46291,1.4364014799639,103.78248384607947,WOODLANDS,16806,53403,-36597,35104,0.0013951756824821155,355
46199,1.43955043252866,103.78065534399263,WOODLANDS,26512,75089,-48577,50800,0.0020189985377760786,515
46181,1.44015882292646,103.778867882596,WOODLANDS,112473,169106,-56633,140789,0.005595527266436149,1427
46209,1.44025242879024,103.77727510649777,WOODLANDS,11131,19740,-8609,15435,0.000613449654145153,156
46709,1.44144739085946,103.77554719559573,WOODLANDS,19684,20791,-1107,20237,0.0008043006576569784,205
46119,1.44101545973486,103.77252382232057,WOODLANDS,158977,155636,3341,157306,0.006251979999673304,1595
43631,1.34785920936647,103.7685845905285,BUKIT TIMAH,6599,2253,4346,4426,0.0007339382603043207,57
28279,1.33948295480474,103.73423653369264,JURONG EAST,34146,39311,-5165,36728,0.0035819436413429715,281
28269,1.33653242651923,103.73499280022457,JURONG EAST,8686,5857,2829,7271,0.0007091132709705061,55
28259,1.33415472196842,103.73698833298555,JURONG EAST,6492,14494,-8002,10493,0.0010233428073571063,80
28309,1.32628627629778,103.74578490414557,JURONG EAST,9913,8953,960,9433,0.0009199649958829299,72
21181,1.329915,103.720953,BOON LAY,7580,12662,-5082,10121,0.013501633509557598,0
21191,1.33290982216515,103.72044541450344,JURONG WEST,7559,12368,-4809,9963,0.0004093050068359236,53
21271,1.33465896770641,103.71947315443572,JURONG WEST,11532,6466,5066,8999,0.00036970147109469803,48
21201,1.33683396424463,103.71778639139953,JURONG WEST,2821,2322,499,2571,0.00010562312281192006,13
21211,1.34004972199531,103.71606833298439,JURONG WEST,48810,17959,30851,33384,0.0013714983788226912,179
21229,1.34206,103.716007,JURONG WEST,16744,27426,-10682,22085,0.0009073071440300484,118
21219,1.34010356133429,103.71625930906035,JURONG WEST,11201,46346,-35145,28773,0.0011820669438612898,154
21209,1.33687648564633,103.71805599895127,JURONG WEST,2647,2041,606,2344,9.629739395999245e-05,12
21279,1.33491282590378,103.71952517818409,JURONG WEST,7186,20358,-13172,13772,0.0005657882720209113,74
21199,1.333309472028,103.72051292839538,JURONG WEST,12988,21168,-8180,17078,0.0007016070367102181,91
21189,1.33026046590704,103.72122294249655,BOON LAY,16273,18202,-1929,17237,0.022994531845098736,0
28251,1.33382805600325,103.7369883329766,JURONG EAST,19160,13811,5349,16485,0.001607720020897922,126
28261,1.33614236992322,103.73489878344925,JURONG EAST,5358,6840,-1482,6099,0.0005948125209254732,46
28271,1.33899259685337,103.73390575121081,JURONG EAST,11862,15338,-3476,13600,0.0013263568264611308,104
43639,1.34810218754524,103.76845262919154,BUKIT BATOK,1577,5031,-3454,3304,0.00026584728200120564,20
46111,1.44132222201705,103.77372416702165,WOODLANDS,72024,75614,-3590,73819,0.0029338671862222904,748
46201,1.44071020952285,103.77680238652405,WOODLANDS,14934,18213,-3279,16573,0.0006586784009165935,168
46189,1.44008271628617,103.77854042726402,WOODLANDS,186890,98096,88794,142493,0.005663251154396197,1444
46191,1.43978268235949,103.78053807087814,WOODLANDS,64071,22196,41875,43133,0.001714280786021567,437
46299,1.43692705673107,103.78274585693057,WOODLANDS,27658,5413,22245,16535,0.0006571681264198319,167
22501,1.33769199118033,103.70297133237953,JURONG WEST,61930,31993,29937,46961,0.001929275562182255,252
22511,1.33746181720219,103.70029665103546,JURONG WEST,100563,135988,-35425,118275,0.004859033391901923,635
22521,1.33741647896432,103.69776790191162,JURONG WEST,572571,256941,315630,414756,0.017039215840132522,2229
22451,1.33817022625307,103.69561280580359,JURONG WEST,58585,75167,-16582,66876,0.0027474336682885903,359
27301,1.34045284969365,103.69439784182157,JURONG WEST,72175,154666,-82491,113420,0.004659577825487348,609
27321,1.34403944399659,103.6917308330011,JURONG WEST,38233,103839,-65606,71036,0.0029183368930640035,381
27281,1.34565500002282,103.68780555602468,WESTERN WATER CATCHMENT,24563,37233,-12670,30898,0.02171753984091048,6
27291,1.34772267411254,103.68649929145208,WESTERN WATER CATCHMENT,14101,19773,-5672,16937,0.01190465312594669,3
27311,1.34902211051484,103.68539285058924,WESTERN WATER CATCHMENT,27860,31088,-3228,29474,0.020716640859311138,6
27061,1.34984722128218,103.68387082088056,WESTERN WATER CATCHMENT,27860,31887,-4027,29873,0.02099708938013848,6
27211,1.34793140650697,103.68050066497821,WESTERN WATER CATCHMENT,257058,262602,-5544,259830,0.18262892021696453,52
27221,1.34623151653928,103.67851763727317,WESTERN WATER CATCHMENT,48960,47599,1361,48279,0.03393427102010865,9
27231,1.34207972361937,103.67922271593845,WESTERN WATER CATCHMENT,83042,101998,-18956,92520,0.06503031866402478,18
27241,1.33998726585628,103.68089382456998,WESTERN WATER CATCHMENT,29031,16666,12365,22848,0.016059367929481608,4
27251,1.34162269584125,103.68420609962317,WESTERN WATER CATCHMENT,110033,53135,56898,81584,0.05734363940646128,16
27261,1.34332011366726,103.68632093846232,WESTERN WATER CATCHMENT,38621,15150,23471,26885,0.018896888427175813,5
27329,1.34404250003243,103.69186499999779,JURONG WEST,91178,40162,51016,65670,0.0026978881661061027,352
27309,1.3410704693164,103.69426536144466,JURONG WEST,150385,69409,80976,109897,0.00451484415700567,590
22459,1.33856290426228,103.69572041924057,JURONG WEST,25516,118227,-92711,71871,0.002952640785536953,386
22529,1.33777262767008,103.69728617102128,JURONG WEST,196608,884986,-688378,540797,0.022217295973285853,2906
22519,1.33773359608761,103.6999522210238,JURONG WEST,117170,84056,33114,100613,0.004133434171713618,540
22509,1.33799405073941,103.70323491142737,JURONG WEST,15141,44310,-29169,29725,0.0012211774895310478,159
76201,1.35687499368341,103.9479674220669,TAMPINES,73573,33588,39985,53580,0.0022363495029444017,581
76211,1.35674667237884,103.95100259167165,TAMPINES,116509,85524,30985,101016,0.004216257584722502,1095
76221,1.3563896244901,103.95390226733993,TAMPINES,278162,106432,171730,192297,0.008026190749677111,2086
76469,1.35630339357193,103.95985048163843,TAMPINES,35786,55206,-19420,45496,0.0018989353674124393,493
76439,1.35288166702581,103.96260527798987,TAMPINES,90452,79215,11237,84833,0.0035408032359701834,920
76449,1.35207508249597,103.96113006140774,TAMPINES,73218,47574,25644,60396,0.002520839204550767,655
76459,1.35208003080961,103.95873194771903,TAMPINES,78523,55543,22980,67033,0.00279785771240896,727
76419,1.35366243500181,103.95648530342,TAMPINES,43407,37819,5588,40613,0.0016951262105838183,440
76411,1.35385001382018,103.95742752062093,TAMPINES,18346,67619,-49273,42982,0.0017940047468375563,466
76451,1.35220340979899,103.95928609997816,TAMPINES,4295,18267,-13972,11281,0.0004708521601850652,122
76441,1.35219503409437,103.96105194447786,TAMPINES,7438,19738,-12300,13588,0.000567142908660107,147
76431,1.353726389,103.9612131,TAMPINES,12994,13965,-971,13479,0.0005625934107911084,146
76461,1.35610972200156,103.95981833302024,TAMPINES,35763,47330,-11567,41546,0.0017340682428019431,450
76229,1.35614001051089,103.95353851635838,TAMPINES,68010,122113,-54103,95061,0.00396770474242997,1031
76219,1.35644168689504,103.95114418566536,TAMPINES,77357,57933,19424,67645,0.002823401682095447,733
76209,1.35660332787929,103.94766913185744,TAMPINES,48980,86406,-37426,67693,0.0028254051306983085,734
28379,1.34513639882838,103.72426131705271,JURONG WEST,39591,29793,9798,34692,0.0014252342966126529,186
28369,1.34449722197147,103.72747138899737,JURONG WEST,27079,10111,16968,18595,0.0007639291982449061,99
28359,1.34388722199927,103.73119944403174,JURONG EAST,35638,46530,-10892,41084,0.0040067679307594925,314
28349,1.34255113741933,103.73318514055593,JURONG EAST,33060,14839,18221,23949,0.0023356558556557076,183
28341,1.34247027799798,103.73271277802048,JURONG EAST,122836,203153,-80317,162994,0.015896191512662174,1249
28351,1.343615278018,103.73105583301476,JURONG EAST,8353,26342,-17989,17347,0.0016917876373986204,132
28361,1.34418881822068,103.72748780602458,JURONG EAST,7595,33651,-26056,20623,0.002011283590596169,158
28371,1.34487972199034,103.72409194399874,JURONG EAST,5665,23386,-17721,14525,0.0014165685959079356,111
22441,1.342816,103.70358,JURONG WEST,41748,99745,-57997,70746,0.0029064229663368713,380
22591,1.3447589,103.70289,JURONG WEST,54788,141270,-86482,98029,0.004027276976324275,526
27371,1.34751384306624,103.700994411555,JURONG WEST,27699,141287,-113588,84493,0.003471184175708892,454
27381,1.348143,103.698209,JURONG WEST,64240,176156,-111916,120198,0.004938035050854596,646
27439,1.34941077845235,103.6971171383191,JURONG WEST,76407,154054,-77647,115230,0.004733937161267035,619
27449,1.35053242519874,103.70107895859192,JURONG WEST,20972,33307,-12335,27139,0.0011149381291297932,145
27459,1.35145070001383,103.70399035610369,JURONG WEST,68225,135739,-67514,101982,0.004189676122366873,548
27469,1.35307192192765,103.70486709831036,JURONG WEST,119184,117850,1334,118517,0.004868975358343185,637
27461,1.35293305775698,103.70512862147237,JURONG WEST,60655,58499,2156,59577,0.0024475724573184603,320
27451,1.35128613677034,103.7041505569119,JURONG WEST,101987,58610,43377,80298,0.0032988430632250316,431
27441,1.35032868767666,103.70079327483805,JURONG WEST,32395,30202,2193,31298,0.0012858002713992509,168
27431,1.34946527300866,103.69734630614052,JURONG WEST,66707,91079,-24372,78893,0.003241122142357374,424
27389,1.34845180903204,103.69810437813979,JURONG WEST,211815,79385,132430,145600,0.005981612867139463,782
27379,1.34805042142493,103.70087385175057,JURONG WEST,172934,37178,135756,105056,0.004315963745674474,564
22599,1.3443608,103.7034508,JURONG WEST,267602,76508,191094,172055,0.0070684505621956065,924
22449,1.343058,103.703812,JURONG WEST,54979,32655,22324,43817,0.0018001121634577601,235
27479,1.3518923433776,103.70818261767401,JURONG WEST,33777,27807,5970,30792,0.001265012523385703,165
24009,1.32697254709069,103.67839791240787,PIONEER,1012738,831901,180837,922319,0.42027245378829786,33
23081,1.33011660553179,103.67826798978071,PIONEER,2195,1927,268,2061,0.0009391344288230883,0
24041,1.33035313055333,103.67499316670492,PIONEER,188,26037,-25849,13112,0.005974735871289827,0
24501,1.32424896848956,103.66479791875364,PIONEER,273,146,127,209,9.523488385445194e-05,0
25219,1.32877104016653,103.65692226679495,TUAS,1933,6369,-4436,4151,0.0026811261892612853,0
25229,1.33371272924751,103.65176249706444,TUAS,773,12353,-11580,6563,0.004239034252016819,0
25239,1.33740500002037,103.64795499996725,TUAS,1192,3331,-2139,2261,0.0014603773341170239,0
25249,1.33985499996776,103.64535166698558,TUAS,523,987,-464,755,0.0004876536431925489,0
25259,1.34418817757747,103.6407070702331,TUAS,2300,1119,1181,1709,0.0011038411605510808,0
25269,1.34777150726774,103.63746924027154,TUAS,16172,15848,324,16010,0.01034084083114266,0
25411,1.34387062081224,103.63830559259954,TUAS,2383,991,1392,1687,0.0010896313855176558,0
25421,1.3414665264837,103.63745040018382,TUAS,204358,8636,195722,106497,0.06878629144248594,4
25431,1.33897644927954,103.63658739973077,TUAS,3192,452,2740,1822,0.0011768277323136744,0
25441,1.33483211759061,103.6351235369854,TUAS,2282,3211,-929,2746,0.0017736382837175355,0
25451,1.3322832999168,103.63410305264573,TUAS,1066,10192,-9126,5629,0.003635764711961401,0
25461,1.32944826490136,103.63291879027565,TUAS,2305,4541,-2236,3423,0.0022109118154279403,0
26201,1.32695291537121,103.63192950215767,TUAS,2105,2033,72,2069,0.0013363647520071307,0
26249,1.32047370757812,103.63121830364248,TUAS,249,10363,-10114,5306,0.0034271393785161117,0
26259,1.31751639387096,103.63011079068617,TUAS,498,19324,-18826,9911,0.0064015036525580825,0
26269,1.3143583329901,103.62895500001656,TUAS,2022,92781,-90759,47401,0.030616252107245046,2
26279,1.31133425245546,103.6278418960082,TUAS,3710,6613,-2903,5161,0.0033334840430685364,0
26289,1.30854575415228,103.62682065616312,TUAS,459,10575,-10116,5517,0.0035634240390639634,0
26299,1.30510954355111,103.62556346611815,TUAS,3077,25295,-22218,14186,0.009162721301098674,0
26369,1.2984699944142,103.62308583345813,TUAS,4048,11871,-7823,7959,0.005140709067774168,0
26379,1.29387380677403,103.62192147229634,TUAS,3447,4770,-1323,4108,0.0026533525380595907,0
26389,1.29055080908937,103.62453377233186,TUAS,3634,10340,-6706,6987,0.004512895370842833,0
26399,1.28949499042217,103.627460343254,TUAS,5013,6971,-1958,5992,0.003870226000012918,0
26409,1.28912909258559,103.63019873280872,TUAS,3230,2291,939,2760,0.0017826808678297152,0
26419,1.28891937327423,103.63301962123198,TUAS,5594,4717,877,5155,0.003329608649877602,0
26429,1.28869749978137,103.63586909363458,TUAS,10680,10234,446,10457,0.006754164432933091,0
26211,1.2909661076742,103.6368386816709,TUAS,1458,1879,-421,1668,0.0010773593070796976,0
26221,1.29324977797865,103.63700231055886,TUAS,3902,5942,-2040,4922,0.0031791142142963253,0
26431,1.29448159014169,103.63619121489278,TUAS,493,187,306,340,0.00021960561415293594,0
26441,1.29568927488087,103.63296571362545,TUAS,1723,1029,694,1376,0.0008887568384542348,0
26451,1.29689770170555,103.62977787735203,TUAS,8600,2659,5941,5629,0.003635764711961401,0
26461,1.29946472196917,103.62876777798095,TUAS,24260,5032,19228,14646,0.009459834779070293,0
26311,1.30228826515768,103.62978115947503,TUAS,8868,553,8315,4710,0.0030421836548833185,0
26321,1.30603953289231,103.63116893582946,TUAS,1367,180,1187,773,0.0004992798227653514,0
26331,1.30869957612651,103.63213426017337,TUAS,9636,992,8644,5314,0.0034323065694373575,0
26349,1.3119396916744,103.62993851893346,TUAS,25245,2936,22309,14090,0.009100715010043727,0
26261,1.31470906872568,103.62871219060811,TUAS,55813,9593,46220,32703,0.02112283058718666,1
26251,1.31744784261205,103.62972683501111,TUAS,11212,557,10655,5884,0.003800468922576103,0
26241,1.32051139798651,103.63084994911132,TUAS,6184,331,5853,3257,0.0021036926038120953,0
26209,1.32692000001177,103.63175333302223,TUAS,4738,3467,1271,4102,0.0026494771448686565,0
25469,1.32929472200012,103.63264583299014,TUAS,9279,2988,6291,6133,0.003961297739999871,0
25459,1.33279999997118,103.63412166700834,TUAS,11152,4001,7151,7576,0.004893329802419537,0
25449,1.33559254994067,103.63488564434365,TUAS,3495,4790,-1295,4142,0.0026753130994748844,0
25439,1.33912525432561,103.63642647473378,TUAS,1369,20295,-18926,10832,0.006996376507366476,0
25429,1.34055807307548,103.63696536000046,TUAS,12305,175624,-163319,93964,0.060691240965489626,4
25419,1.3443890810874,103.63837611639327,TUAS,1102,3278,-2176,2190,0.0014145185146909698,0
25231,1.3386589540233,103.64740272813636,TUAS,2742,422,2320,1582,0.0010218120046763077,0
25221,1.33470589408796,103.65153114279171,TUAS,1681,1735,-54,1708,0.0011031952616859253,0
24509,1.32431478516881,103.66411622471436,TUAS,364,393,-29,378,0.0002441497710288523,0
24049,1.33094144977498,103.67379074701834,WESTERN WATER CATCHMENT,35495,425,35070,17960,0.012623697829722062,3
23089,1.330433728881,103.67843466317231,JURONG WEST,2382,1092,1290,1737,7.136031284492615e-05,9
28661,1.33665522766949,103.74951999566713,CLEMENTI,22105,61578,-39473,41841,0.003895282343034533,169
28671,1.33715229988486,103.75226376356609,CLEMENTI,76986,78865,-1879,77925,0.0072546037757454645,316
28681,1.33720242588623,103.75488889772056,CLEMENTI,57676,74946,-17270,66311,0.006173372229367436,269
28691,1.33565242851513,103.75748934005021,CLEMENTI,19082,20884,-1802,19983,0.0018603624927907812,81
28701,1.33149833298375,103.75773000000456,CLEMENTI,10703,13069,-2366,11886,0.0011065540003658723,48
16159,1.30060333385651,103.77017032679849,QUEENSTOWN,24535,132362,-107827,78448,0.006812627050700785,653
16149,1.29781833402646,103.76994027003138,QUEENSTOWN,7539,24028,-16489,15783,0.0013706365075108415,131
16139,1.29537944399618,103.76974861100446,QUEENSTOWN,3124,27643,-24519,15383,0.0013358994738034134,128
16101,1.28923831874246,103.77969239279669,QUEENSTOWN,1517,9602,-8085,5559,0.000482757925948981,46
16111,1.28700981956328,103.7828311158184,QUEENSTOWN,8981,26294,-17313,17637,0.0015316426587447703,146
16121,1.28651130049582,103.78345136824991,QUEENSTOWN,19785,19841,-56,19813,0.0017206121221131788,165
16119,1.28697650703193,103.78260551222012,QUEENSTOWN,21773,401,21372,11087,0.0009628237317856363,92
16109,1.28911169277414,103.77950843257454,QUEENSTOWN,22441,1268,21173,11854,0.0010294319939196297,98
16131,1.29487639088562,103.76935201010454,CLEMENTI,35268,4047,31221,19657,0.0018300127869082914,79
16141,1.29786833526113,103.76959523650599,QUEENSTOWN,15903,3431,12472,9667,0.0008395072621242669,80
16151,1.30076138899694,103.76993555602371,QUEENSTOWN,86290,20003,66287,53146,0.004615335983537425,442
28709,1.331639972025,103.75734406053928,CLEMENTI,15342,7507,7835,11424,0.0010635430674894603,46
28699,1.33566850623054,103.75723501585756,CLEMENTI,25227,26280,-1053,25753,0.0023975336674593897,104
28689,1.33727934409499,103.75440999786483,CLEMENTI,87112,95492,-8380,91302,0.00849996578675794,370
28679,1.33661449274468,103.75110456918219,CLEMENTI,71955,70496,1459,71225,0.006630852151780183,289
28669,1.33644500000269,103.74935500317244,CLEMENTI,41191,8865,32326,25028,0.002330038155910908,101
44241,1.38117443945082,103.76586096715347,BUKIT PANJANG,150238,89568,60670,119903,0.014300648403084521,974
44231,1.37916686797468,103.76933485417399,BUKIT PANJANG,102911,72742,30169,87826,0.010474873411418407,713
43139,1.37322530507327,103.77029311221521,BUKIT PANJANG,19641,12066,7575,15853,0.0018907631930318585,128
43129,1.37162881663563,103.76760246505873,BUKIT PANJANG,20948,21814,-866,21381,0.0025500793433554637,173
42109,1.343246111,103.7769164,BUKIT PANJANG,16957,19380,-2423,18168,0.002166869721251675,147
17229,1.31728402491862,103.76824211745355,CLEMENTI,80877,93816,-12939,87346,0.008131673036846499,354
43121,1.37118669285497,103.76669327756966,BUKIT PANJANG,19499,20235,-736,19867,0.0023695068665844908,161
43131,1.37331749997168,103.7700624999975,BUKIT PANJANG,14713,36124,-21411,25418,0.003031566191918487,206
44239,1.37846111098819,103.76983083299403,BUKIT PANJANG,79342,70183,9159,74762,0.008916750005516167,607
44249,1.38049595009817,103.76649141308671,BUKIT PANJANG,78889,97683,-18794,88286,0.010529736911626232,717
22609,1.33048210252836,103.69830144019609,JURONG WEST,0,1320,-1320,660,2.71144539307146e-05,3
22191,1.33130584013018,103.69832754842358,JURONG WEST,33882,0,33882,16941,0.000695978733394297,91
22181,1.33301611112037,103.69637694442996,JURONG WEST,70132,28983,41149,49557,0.002035925747643066,266
22461,1.33596194443399,103.6962049999685,JURONG WEST,71530,34283,37247,52906,0.0021735110600884645,284
27369,1.34285373346865,103.6941039562493,JURONG WEST,148187,125814,22373,137000,0.005628303315921061,736
27359,1.34441434989381,103.69601368907118,JURONG WEST,92010,53149,38861,72579,0.002981727199753538,390
12209,1.32653202760922,103.76429968220569,CLEMENTI,59705,21978,37727,40841,0.003802185085726282,165
17379,1.32049089180327,103.76389432891798,CLEMENTI,31727,15403,16324,23565,0.0021938368684689363,95
11381,1.30841137865065,103.79328294102335,QUEENSTOWN,119360,3795,115565,61577,0.005347505811505739,512
17371,1.32058194734278,103.76356592222618,CLEMENTI,19044,86396,-67352,52720,0.004908087405290996,214
12201,1.32670826856501,103.76399509585458,CLEMENTI,28408,74785,-46377,51596,0.004803446088076522,209
27471,1.35216655807357,103.70782478135614,JURONG WEST,22495,28673,-6178,25584,0.0010510548323687913,137
27351,1.34423200986065,103.69613170622605,JURONG WEST,102464,177975,-75511,140219,0.005760547902592228,753
27361,1.34294490356227,103.6945223808434,JURONG WEST,59531,107503,-47972,83517,0.0034310876498961987,448
22469,1.33649062479414,103.69631873743737,JURONG WEST,109858,41541,68317,75699,0.0031099046183350977,406
22189,1.33369710730493,103.69666289847902,JURONG WEST,34733,98309,-63576,66521,0.002732849378674342,357
22199,1.33102248150132,103.69847431049809,JURONG WEST,0,27026,-27026,13513,0.0005551479029784036,72
03041,1.28179509394707,103.84893207391676,OUTRAM,52840,14076,38764,33458,0.010698336830378697,97
06141,1.28963300933974,103.83381241921823,BUKIT MERAH,14794,39483,-24689,27138,0.0015814885304785032,239
05129,1.28601166699569,103.84634666701143,OUTRAM,7705,20251,-12546,13978,0.004469524544653997,40
05319,1.284437,103.849114,DOWNTOWN CORE,3542,35533,-31991,19537,0.0040696953821445425,6
46549,1.43319818915334,103.7812567265195,WOODLANDS,114150,68642,45508,91396,0.0036324486291059543,926
46539,1.43209962904173,103.77822365534921,WOODLANDS,167630,77185,90445,122407,0.00486495185066056,1241
46529,1.43208152770031,103.77459689006626,WOODLANDS,539589,177704,361885,358646,0.014254050188567707,3636
46491,1.43188974761143,103.77200799456398,WOODLANDS,40788,4450,36338,22619,0.0008989710221645103,229
43529,1.36769649857951,103.7502379581868,BUKIT BATOK,134771,112834,21937,123802,0.009961387774307887,771
43641,1.36530401539571,103.75026447996078,BUKIT BATOK,105348,145725,-40377,125536,0.010100909320007068,782
43831,1.36512501870188,103.74788610102789,BUKIT BATOK,55049,59942,-4893,57495,0.004626177202984055,358
43491,1.36395398644152,103.74714799810218,BUKIT BATOK,192975,155976,36999,174475,0.014038651491271294,1087
43481,1.35992912103835,103.74637905142735,BUKIT BATOK,100145,21112,79033,60628,0.004878265439821155,377
43471,1.35796999999619,103.74730694399486,BUKIT BATOK,80863,31592,49271,56227,0.004524151066913375,350
43461,1.35504665794029,103.74749372345552,BUKIT BATOK,7511,3162,4349,5336,0.000429346578922044,33
43701,1.34847060052694,103.75201666213025,BUKIT BATOK,54164,36576,17588,45370,0.0036505723923712773,282
28321,1.34127166427214,103.74090313908255,JURONG EAST,133517,160404,-26887,146960,0.014332455824759395,1126
28331,1.34204392869092,103.73804926872124,JURONG EAST,126316,184003,-57687,155159,0.015132073443888425,1189
28399,1.34974947213063,103.71964821094637,JURONG WEST,241685,74420,167265,158052,0.0064931722312989455,849
28389,1.34646209983221,103.72147231551902,JURONG WEST,79466,42026,37440,60746,0.0024955979067805894,326
28381,1.34626967118054,103.72129604136144,JURONG WEST,69158,58466,10692,63812,0.0026215568700405454,343
28391,1.34978093237085,103.71937165971983,JURONG WEST,123395,274457,-151062,198926,0.008172378579729292,1069
28339,1.34270510558579,103.73737517747826,JURONG EAST,196986,164838,32148,180912,0.017643666631524713,1386
28329,1.3414709231345,103.74043571670437,JURONG EAST,170516,120804,49712,145660,0.01420567171634767,1116
43709,1.3486867689202,103.75207088829217,BUKIT BATOK,27586,86575,-58989,57080,0.004592785368229061,355
43469,1.35546802880026,103.74730862146369,BUKIT BATOK,2612,11275,-8663,6943,0.0005586494185636715,43
43479,1.35765247384472,103.74723575988492,BUKIT BATOK,23134,72549,-49415,47841,0.0038493946181052297,298
43489,1.35978620558748,103.74635170320164,BUKIT BATOK,12874,62203,-49329,37538,0.003020392031404739,234
43499,1.36259558126251,103.74686723054008,BUKIT BATOK,140580,224252,-83672,182416,0.014677602237751795,1137
43839,1.36527346533705,103.74824970624866,BUKIT BATOK,40018,38793,1225,39405,0.0031706150566760015,245
43649,1.36545844046425,103.7506020069351,BUKIT BATOK,79391,60032,19359,69711,0.005609104078567206,434
43521,1.36756037490262,103.750164221858,BUKIT BATOK,100141,122850,-22709,111495,0.008971138833754366,695
46521,1.43237833345523,103.77429333367095,WOODLANDS,571843,1055400,-483557,813621,0.032336606482360454,8250
46531,1.43240249999047,103.77751138903017,WOODLANDS,88537,180805,-92268,134671,0.005352373072457526,1365
46541,1.43328331503309,103.78083569681783,WOODLANDS,170947,197743,-26796,184345,0.007326619792250614,1869
44461,1.3825705560115,103.7430047219692,CHOA CHU KANG,109638,37957,71681,73797,0.006236494440589905,1197
44451,1.38077375279629,103.74424353296656,CHOA CHU KANG,101129,18042,83087,59585,0.005035455658665657,967
44441,1.37924285981093,103.74754322627454,CHOA CHU KANG,53075,26884,26191,39979,0.003378576517207255,648
44121,1.37769846227758,103.75093552549583,CHOA CHU KANG,123722,65580,58142,94651,0.007998840539537855,1536
20019,1.31357611099308,103.7615108330155,CLEMENTI,87396,84951,2445,86173,0.00802246995402392,350
17149,1.31171515103681,103.76346179699715,CLEMENTI,69587,42973,26614,56280,0.0052395136413083705,228
17139,1.30903304650021,103.7658699915105,CLEMENTI,17574,12663,4911,15118,0.0014074443359861396,61
17191,1.305669444,103.7698914,CLEMENTI,97207,90804,6403,94005,0.008751607673262142,381
17121,1.30476410258543,103.76944539352431,CLEMENTI,150249,151592,-1343,150920,0.014050238072961251,613
17131,1.3080413890204,103.76591111102081,CLEMENTI,18202,21093,-2891,19647,0.0018290818143352088,79
17141,1.3109950000148,103.76349999999258,CLEMENTI,55057,84085,-29028,69571,0.006476869288192335,282
44129,1.37741713631203,103.75092697249079,CHOA CHU KANG,72395,149728,-77333,111061,0.009385629619989368,1802
44449,1.37889232196067,103.74762704486072,CHOA CHU KANG,28078,50499,-22421,39288,0.003320180950199821,637
44459,1.38028731431529,103.74454562435122,CHOA CHU KANG,76496,197663,-121167,137079,0.01158437905906234,2225
44469,1.38243888902379,103.74275222200647,CHOA CHU KANG,68165,111392,-43227,89778,0.007587029254404386,1457
43599,1.34513161798285,103.75190146961904,BUKIT BATOK,19164,26568,-7404,22866,0.0018398498638739613,142
43509,1.34359093090915,103.75436398130816,BUKIT BATOK,56049,68267,-12218,62158,0.0050013726860263135,387
43219,1.3413740257309,103.75446757134857,BUKIT BATOK,18641,37923,-19282,28282,0.002275633422989739,176
43319,1.33972179277053,103.7574111060431,BUKIT BATOK,41932,95284,-53352,68608,0.005520354214146101,427
16991,1.30777929773028,103.76988582423061,CLEMENTI,100736,71033,29703,85884,0.007995564846661835,348
16891,1.30982186660782,103.76816139829276,CLEMENTI,38842,50069,-11227,44455,0.004138638573638301,180
43311,1.339803833761,103.75695468286781,BUKIT BATOK,69903,45371,24532,57637,0.004637602842827933,359
43211,1.34087277799084,103.75507916698768,BUKIT BATOK,35570,13697,21873,24633,0.0019820266639030567,153
43501,1.34376366037202,103.75423776871699,BUKIT BATOK,54738,45845,8893,50291,0.004046527136538327,313
43591,1.3447586640008,103.7521198162659,BUKIT BATOK,25786,17966,7820,21876,0.0017601922339765058,136
98021,1.36473730490409,103.96537675659532,PASIR RIS,26882,72029,-45147,49455,0.004663284108050145,338
99181,1.38775412603923,103.98850309975099,CHANGI,41261,34962,6299,38111,0.01216263612396436,22
99171,1.39112750002185,103.9910213889211,CHANGI,1452,8636,-7184,5044,0.0016097278111116536,2
99161,1.39026180023806,103.99295664134459,CHANGI,355,2253,-1898,1304,0.00041615485045392475,0
95071,1.38994660051217,103.99512197669611,CHANGI,360,2198,-1838,1279,0.0004081764215725228,0
95081,1.38959028129733,103.99761693950214,CHANGI,325,12919,-12594,6622,0.0021133262421057434,3
95091,1.38721361114033,103.99971361110026,CHANGI,872,39704,-38832,20288,0.006474654605835295,11
95131,1.38525245892982,103.99983438993594,CHANGI,48997,101990,-52993,75493,0.02409262126174704,44
95141,1.38138618483813,103.99819135664978,CHANGI,21640,80893,-59253,51266,0.016360885401358057,30
95061,1.37755167138896,103.99653899373014,CHANGI,46199,207440,-161241,126819,0.04047265489242046,74
95051,1.37528324353604,103.99619579312593,CHANGI,55794,72376,-16582,64085,0.02045190459458571,37
95041,1.37265452174649,103.99570041596903,CHANGI,37078,54499,-17421,45788,0.014612652064865264,27
95039,1.37218943783154,103.99457879033221,CHANGI,35090,45433,-10343,40261,0.012848781007764926,23
95049,1.37359444402021,103.99443416702756,CHANGI,54675,21648,33027,38161,0.012178592981727163,22
95069,1.37789848118317,103.99643160040588,CHANGI,143717,2486,141231,73101,0.023329245186374505,43
95149,1.38128155042147,103.99785682775334,CHANGI,57879,5574,52305,31726,0.010124945387654306,18
95139,1.38557240860116,103.99899787539849,CHANGI,103630,32283,71347,67956,0.021687284522581986,40
95099,1.38815449129359,103.99878608257899,CHANGI,41105,572,40533,20838,0.006650180041226137,12
95089,1.38962166669625,103.99593111108919,CHANGI,1462,347,1115,904,0.00028849998835149386,0
95079,1.39019416668503,103.99252027779501,CHANGI,7156,1050,6106,4103,0.001309419748015685,2
99189,1.3884141666958,103.9897163888532,CHANGI,9439,28904,-19465,19171,0.006118178403414257,11
98029,1.36438833297951,103.96545638898216,PASIR RIS,17582,6146,11436,11864,0.0011186978598302887,81
44299,1.38177250001353,103.75131333302434,CHOA CHU KANG,149368,287727,-138359,218547,0.018469140351336802,3547
44289,1.38140148022937,103.75380266661918,CHOA CHU KANG,202498,177346,25152,189922,0.016050076522700327,3082
44279,1.37910867690077,103.75635459940506,CHOA CHU KANG,52256,51147,1109,51701,0.004369188436832645,839
44271,1.37867114732017,103.75614774814443,CHOA CHU KANG,52601,64383,-11782,58492,0.004943087562082262,949
44281,1.38104915821148,103.75422740795686,CHOA CHU KANG,189479,155938,33541,172708,0.014595342383096892,2803
44291,1.38151999999791,103.75140111097832,CHOA CHU KANG,307284,159990,147294,233637,0.01974437784213591,3792
18151,1.30051083054497,103.78864286195989,QUEENSTOWN,13613,2044,11569,7828,0.0006798037496543666,65
18171,1.29905478616662,103.79412910351343,QUEENSTOWN,50,1201,-1151,625,5.427661516785629e-05,5
18181,1.29714585347396,103.79369361976173,QUEENSTOWN,1150,7580,-6430,4365,0.0003790678803323084,36
18191,1.29445611099682,103.79594388899301,QUEENSTOWN,2991,4001,-1010,3496,0.00030360167460292097,29
18211,1.29161816867907,103.79522263706237,QUEENSTOWN,3672,5650,-1978,4661,0.0004047732852758051,38
18201,1.29498098725808,103.7932287526945,QUEENSTOWN,12117,13938,-1821,13027,0.0011312983452666622,108
18199,1.29544342826531,103.79407617440387,QUEENSTOWN,3717,307,3410,2012,0.00017472727954836298,16
18189,1.29839662957663,103.79390316193482,QUEENSTOWN,8283,59,8224,4171,0.00036222041898420574,34
18179,1.29988107543841,103.79304547568137,QUEENSTOWN,1363,815,548,1089,9.457157426847281e-05,9
18159,1.3003468994065,103.78858368998314,QUEENSTOWN,3493,12111,-8618,7802,0.0006775458424633837,64
22251,1.34073333303053,103.70265666700926,JURONG WEST,28185,73374,-45189,50779,0.0020861285699208436,272
22241,1.34012270744787,103.69938392223636,JURONG WEST,25389,118614,-93225,72001,0.002957981511311185,387
22539,1.33919523713654,103.69838678279567,JURONG WEST,8781,37135,-28354,22958,0.0009431721717293118,123
22479,1.33474242487786,103.693102645977,JURONG WEST,4531,18525,-13994,11528,0.0004735991286564817,61
23041,1.33334088691759,103.69055967203332,JURONG WEST,2974,34826,-31852,18900,0.0007764593625613726,101
23051,1.33168972198862,103.68928138898715,JURONG WEST,8460,23727,-15267,16093,0.0006611407683439243,86
23061,1.329527778021,103.68652222202904,JURONG WEST,1681,21918,-20237,11799,0.0004847324877704569,63
23071,1.32977056006705,103.68257796013837,JURONG WEST,9320,20412,-11092,14866,0.0006107325335363685,79
23379,1.3265431228454,103.67939439835483,PIONEER,2003,1914,89,1958,0.0008922004908469707,0
23519,1.32479352408668,103.6793660000188,PIONEER,9562,4360,5202,6961,0.0031719140024442103,0
24011,1.32230923979842,103.6776263194759,PIONEER,297,1195,-898,746,0.0003399292983512973,0
24021,1.32185257239826,103.67087977752024,PIONEER,9883,6765,3118,8324,0.0037929912593514734,0
24511,1.319446944,103.6608911,PIONEER,38163,12548,25615,25355,0.011553495120237458,0
25201,1.31926000001423,103.65870833303143,TUAS,36378,1408,34970,18893,0.012202967259386525,0
25199,1.32109472197296,103.65933166702904,TUAS,748,2178,-1430,1463,0.0009449500397227803,0
25189,1.32383972198116,103.65861666698133,TUAS,1025,5831,-4806,3428,0.002214141309753719,0
25179,1.32529138897633,103.65711333297114,TUAS,1036,12728,-11692,6882,0.004445075990001486,0
25169,1.32774944401039,103.65450055600219,TUAS,864,11381,-10517,6122,0.003954192852483158,0
25129,1.32994444402601,103.65226388900422,TUAS,2958,26794,-23836,14876,0.009608391518056102,0
25119,1.33212638903277,103.64991694402983,TUAS,1353,13797,-12444,7575,0.004892683903554382,0
25109,1.33462333299665,103.64732250002415,TUAS,7822,12920,-5098,10371,0.006698617130529702,0
25099,1.33392910725335,103.6449493341418,TUAS,11055,7235,3820,9145,0.005906745121848821,0
25819,1.332495,103.64353,TUAS,1748,533,1215,1140,0.000736324706277491,0
25519,1.32981451584967,103.6409965426425,TUAS,354,1679,-1325,1016,0.000656233246998185,0
24719,1.330051,103.639332,TUAS,16297,166589,-150292,91443,0.05906292992643212,4
25689,1.332109,103.637126,TUAS,1238,7258,-6020,4248,0.0027437783791813878,0
25009,1.34499542766088,103.63920357507963,TUAS,2229,1438,791,1833,0.001183932619830387,0
25681,1.332541,103.637033,TUAS,3701,972,2729,2336,0.001508819749003701,0
24711,1.329871,103.639994,TUAS,35183,5723,29460,20453,0.013210569489029407,0
25511,1.32981500001918,103.64080472198735,TUAS,1829,241,1588,1035,0.0006685053254361432,0
25811,1.332261,103.643199,TUAS,740,2585,-1845,1662,0.0010734839138887634,0
25091,1.33443305603142,103.64520499998908,TUAS,14162,12606,1556,13384,0.008644710411243808,0
25101,1.33428472907824,103.64783751324052,TUAS,12026,10345,1681,11185,0.007224378806766437,0
25111,1.33239888543698,103.64981610844488,TUAS,15405,2449,12956,8927,0.00576593916924488,0
25121,1.33060763294167,103.65169663523501,TUAS,20948,2052,18896,11500,0.00742783694929048,0
25151,1.32913728132074,103.65325524319752,TUAS,16772,1393,15379,9082,0.005866053493344012,0
25161,1.32735422944929,103.65510623174903,TUAS,11270,733,10537,6001,0.0038760390897993194,0
25171,1.32546645428693,103.65711196773577,TUAS,15546,1323,14223,8434,0.005447511028723122,0
25181,1.32385296919519,103.65881324089645,TUAS,5729,552,5177,3140,0.002028122436588879,0
25191,1.32129979633271,103.6596844024505,TUAS,2255,917,1338,1586,0.0010243956001369306,0
25209,1.31930805600666,103.65880916700371,TUAS,1426,29596,-28170,15511,0.010018537297429969,0
24519,1.319071944,103.6598081,TUAS,6089,59726,-53637,32907,0.02125459395567842,1
24029,1.3224709639188,103.67132658072524,PIONEER,21299,763,20536,11031,0.0050264880564519585,0
24019,1.32288721900936,103.67728206793541,PIONEER,679,354,325,516,0.00023512535918132632,0
23371,1.32595445317751,103.6790814673288,PIONEER,19320,60802,-41482,40061,0.018254567856905258,1
23079,1.33017908917854,103.68181544225693,JURONG WEST,15156,5444,9712,10300,0.0004231498113429703,55
23069,1.32989950511553,103.68582019131013,JURONG WEST,17449,6059,11390,11754,0.00048288377500245363,63
23059,1.33071284667323,103.68813759846915,JURONG WEST,26813,3600,23213,15206,0.0006247005855612821,81
23049,1.33410764081742,103.69061140570352,JURONG WEST,34195,3790,30405,18992,0.0007802389531092904,102
22471,1.33509047686273,103.6931453983202,JURONG WEST,15248,4692,10556,9970,0.000409592584377613,53
22531,1.33922673310366,103.6981437537688,JURONG WEST,26885,8544,18341,17714,0.0007277355104979976,95
22249,1.34016007378301,103.69865436006683,JURONG WEST,95317,27540,67777,61428,0.002523616175842328,330
22259,1.34089136412278,103.7025463831608,JURONG WEST,125115,32006,93109,78560,0.00322744166787415,422
22341,1.34491616105023,103.70103326346653,JURONG WEST,61446,157489,-96043,109467,0.004497178679444751,588
22351,1.34277421893699,103.69803382884736,JURONG WEST,24113,57175,-33062,40644,0.0016697573720605519,218
22361,1.34077805602959,103.69587277801652,JURONG WEST,14183,30675,-16492,22429,0.0009214395260787845,120
22179,1.33000472340216,103.6966590690515,JURONG WEST,3254,20432,-17178,11843,0.00048654011803250455,63
22169,1.32624542877841,103.6966157738775,BOON LAY,3563,36276,-32713,19919,0.026572378013721747,0
23501,1.32453160328451,103.6958354332658,PIONEER,1667,18054,-16387,9860,0.004492899305286584,0
23091,1.32451861639004,103.69276227893867,PIONEER,757,9967,-9210,5362,0.002443298790562542,0
23101,1.32453472201272,103.69091333299923,PIONEER,2689,19381,-16692,11035,0.005028310733654914,0
23111,1.32454666699618,103.68836472199122,PIONEER,1176,3254,-2078,2215,0.0010093075011368949,0
23121,1.32454951872062,103.68564634652004,PIONEER,2612,7058,-4446,4835,0.0022031610690730866,0
23131,1.32537111100949,103.684046944028,PIONEER,8869,9555,-686,9212,0.004197625598407709,0
23141,1.32666880692569,103.68401506144217,PIONEER,1328,697,631,1012,0.0004611373323478725,0
23489,1.32759688194654,103.68048864270644,PIONEER,5683,19920,-14237,12801,0.005833022718759996,0
24521,1.317440843177,103.65887836276522,PIONEER,25,463,-438,244,0.0001111833093803171,0
25321,1.31765021571604,103.6564457850944,TUAS,52,5298,-5246,2675,0.0017277794642914812,0
25331,1.32019777799085,103.6538130560161,TUAS,97,4208,-4111,2152,0.0013899743578150534,0
25341,1.32194305599571,103.6519888889781,TUAS,36,5392,-5356,2714,0.0017529695200325533,0
25351,1.32396971577017,103.65303152916469,TUAS,611,6190,-5579,3400,0.0021960561415293595,0
25369,1.32513576890329,103.65147255685935,TUAS,461,6947,-6486,3704,0.0023924093965366905,0
25371,1.32387805603322,103.64917444402575,TUAS,597,1914,-1317,1255,0.0008106030757703958,0
25381,1.32556305598951,103.64739583301906,TUAS,774,2060,-1286,1417,0.0009152386919256183,0
25061,1.32758500003063,103.64528750001706,TUAS,5522,3188,2334,4355,0.002812889557753047,0
25071,1.32958277801799,103.64320638902281,TUAS,1446,1455,-9,1450,0.0009365533544757562,0
25399,1.32923865523658,103.63794454078865,TUAS,80,139,-59,109,7.040297630197063e-05,0
25391,1.32896999391116,103.63704332757345,TUAS,395,227,168,311,0.0002008745470634208,0
25079,1.32944568983893,103.64347153803386,TUAS,1772,3726,-1954,2749,0.0017755759803130026,0
25069,1.32751179627799,103.64551802153501,TUAS,5223,5551,-328,5387,0.003479457186593723,0
25389,1.32595623010711,103.64720536104248,TUAS,2514,386,2128,1450,0.0009365533544757562,0
25379,1.3242164088822,103.64900097889706,TUAS,1253,119,1134,686,0.00044308662149680604,0
25361,1.32495846442648,103.65112458286887,TUAS,6123,253,5870,3188,0.0020591255821163523,0
25359,1.32365000001897,103.6529238890272,TUAS,5673,597,5076,3135,0.0020248929422631004,0
25349,1.32159222133434,103.65248184445197,TUAS,8460,177,8283,4318,0.0027889912997422863,0
25339,1.32018179763398,103.65396888287178,TUAS,4397,66,4331,2231,0.001441000368162353,0
25329,1.31779138900842,103.65646249999054,TUAS,6156,127,6029,3141,0.0020287683354540346,0
24529,1.31721248927948,103.65816649904158,TUAS,311,3009,-2698,1660,0.0010721921161584518,0
23481,1.32791691676156,103.68174669439477,JURONG WEST,3579,1337,2242,2458,0.00010098079963893407,13
23149,1.32683034567488,103.68416474851742,PIONEER,3162,3305,-143,3233,0.0014731788492892014,0
23139,1.32517166702255,103.68414777801725,PIONEER,7616,4736,2880,6176,0.0028142136013640916,0
23129,1.32468096678984,103.68558762196439,PIONEER,5287,2290,2997,3788,0.001726075311199349,0
23119,1.32467561470377,103.68847743952205,PIONEER,4367,747,3620,2557,0.0011651464019896344,0
23109,1.32468138902865,103.69068388898825,PIONEER,14559,1860,12699,8209,0.0037405892897664876,0
23099,1.32467117178875,103.69286142759196,PIONEER,6734,756,5978,3745,0.0017064815312675717,0
23509,1.32468013030892,103.69561678727867,PIONEER,3308,1035,2273,2171,0.0009892580519043786,0
22161,1.32551656861142,103.69643109025226,PIONEER,44890,4363,40527,24626,0.011221312199998725,0
22171,1.32954166703099,103.69637694399475,JURONG WEST,16938,2342,14596,9640,0.0003960353574122557,51
22369,1.34033186393306,103.69511038795854,JURONG WEST,24531,12927,11604,18729,0.0007694342540429602,100
22359,1.3425266670299,103.69727527800597,JURONG WEST,77435,42227,35208,59831,0.0024580074138311897,321
22349,1.34520537289138,103.7007962851633,JURONG WEST,203116,56453,146663,129784,0.005331851952945248,697
22011,1.32129797964322,103.7077550377112,BOON LAY,8668,29846,-21178,19257,0.025689255655918453,0
22021,1.32168245080395,103.70369314086494,BOON LAY,33141,39743,-6602,36442,0.04861441837321391,0
22031,1.32216806047952,103.69855176773174,BOON LAY,3220,3742,-522,3481,0.004643729497754175,0
22039,1.32284076507861,103.69861624674222,BOON LAY,367,241,126,304,0.0004055425933114821,0
22029,1.32244971744256,103.70268212142697,BOON LAY,4522,84,4438,2303,0.0030722519486721814,0
22019,1.32202402246272,103.7071133033833,BOON LAY,24596,3145,21451,13870,0.018502880819836368,0
02099,1.29147264805943,103.86148558380779,DOWNTOWN CORE,37,341,-304,189,3.9370037734827176e-05,0
02101,1.28938483786533,103.86183148116275,DOWNTOWN CORE,12265,187,12078,6226,0.0012969198673917141,2
04168,1.29208221483052,103.85125994680256,DOWNTOWN CORE,124363,91772,32591,108067,0.0225111209941247,35
04251,1.28973833297563,103.84888472198024,DOWNTOWN CORE,16088,5063,11025,10575,0.002202847349448663,3
04211,1.29043611099357,103.84712444398055,SINGAPORE RIVER,19162,8121,11041,13641,0.010364178433148352,17
04331,1.29183939431601,103.84504089382705,SINGAPORE RIVER,59085,10016,49069,34550,0.026250448271041386,45
04339,1.29221099996741,103.84500500002959,MUSEUM,11912,74512,-62600,43212,0.022770038524426467,11
04219,1.29096802754795,103.84686777836987,MUSEUM,2565,12261,-9696,7413,0.0039061903078212857,1
02181,1.28947444402148,103.85098166700017,DOWNTOWN CORE,11254,27715,-16461,19484,0.004058655107012554,6
19079,1.30607,103.780131,QUEENSTOWN,21580,16521,5059,19050,0.0016543512303162599,158
19069,1.30778758326419,103.77671170466877,QUEENSTOWN,6252,7237,-985,6744,0.0005856663883072366,56
19059,1.30894500001531,103.7727225000061,QUEENSTOWN,29267,71822,-42555,50544,0.004389371579270606,421
19051,1.30896444398008,103.77392333299538,QUEENSTOWN,85761,28280,57481,57020,0.004951764154993866,475
19061,1.30752442673366,103.77782122462926,QUEENSTOWN,15139,11709,3430,13424,0.0011657748512212847,111
82231,1.3142010130892,103.8936761363468,GEYLANG,3932,8110,-4178,6021,0.0004021499023278675,22
81141,1.31200805596649,103.89035749999957,GEYLANG,28846,39378,-10532,34112,0.002278381908023288,127
81151,1.31153305600814,103.88784583298123,GEYLANG,47157,50344,-3187,48750,0.0032560717054448667,181
81161,1.31054638768125,103.88318148792811,GEYLANG,65381,81255,-15874,73318,0.004896998262560138,273
80259,1.30989499998519,103.87988833298908,GEYLANG,40466,44208,-3742,42337,0.002827739647044499,157
18071,1.295425,103.784491,QUEENSTOWN,160613,30809,129804,95711,0.00831179058292911,797
16091,1.299478,103.779229,QUEENSTOWN,89767,65508,24259,77637,0.006742197714858974,646
20011,1.31308624553797,103.76128731220228,CLEMENTI,20947,39896,-18949,30421,0.0028321116645743057,123
17129,1.30514136653386,103.76985839745124,CLEMENTI,89636,53932,35704,71784,0.006682893518615495,291
16099,1.30061249997689,103.77815138886747,QUEENSTOWN,60025,74827,-14802,67426,0.005855448086892605,561
18079,1.2964817739742,103.78455389999202,QUEENSTOWN,33222,146336,-113114,89779,0.007796640373047952,747
80251,1.31009487384598,103.87992501726275,GEYLANG,80627,90940,-10313,85783,0.005729550750936964,320
81169,1.31078371924435,103.88313174959588,GEYLANG,61412,61209,203,61310,0.004094969359196406,228
81159,1.31167873834387,103.8874161243355,GEYLANG,75726,63794,11932,69760,0.004659355121473516,260
81149,1.31212569246254,103.88966028743648,GEYLANG,48159,37247,10912,42703,0.002852185231540762,159
81139,1.31435328604306,103.89191764014708,GEYLANG,22986,56899,-33913,39942,0.0026677746883872586,149
22489,1.34258460261,103.70536833792208,JURONG WEST,23776,25406,-1630,24591,0.0010102599039548527,132
27171,1.35604565059158,103.6916825448322,WESTERN WATER CATCHMENT,5051,41969,-36918,23510,0.01652467349536557,4
27181,1.35587588807417,103.68903620638115,WESTERN WATER CATCHMENT,1441,34355,-32914,17898,0.012580119362826584,3
27011,1.35586334559449,103.68610938870162,WESTERN WATER CATCHMENT,12752,34647,-21895,23699,0.016657517531546946,4
27071,1.35507533539502,103.68452767084537,WESTERN WATER CATCHMENT,32681,29073,3608,30877,0.021702779392445883,6
27021,1.35324138896679,103.68192916699402,WESTERN WATER CATCHMENT,15796,11179,4617,13487,0.009479722306762885,2
27031,1.35186815681876,103.68051749839925,WESTERN WATER CATCHMENT,17521,14031,3490,15776,0.011088611189403966,3
27041,1.35071936245692,103.67864247139183,WESTERN WATER CATCHMENT,4157,6574,-2417,5365,0.0037709431434553927,1
27051,1.34845333297072,103.67665805600423,WESTERN WATER CATCHMENT,3663,3559,104,3611,0.0025380942574123808,0
27219,1.34793269501118,103.68025240016884,WESTERN WATER CATCHMENT,72372,90195,-17823,81283,0.05713207297846872,16
27069,1.35008972199881,103.68418444402793,WESTERN WATER CATCHMENT,10890,8394,2496,9642,0.006777154480744995,1
27209,1.35150701703353,103.68569234331088,WESTERN WATER CATCHMENT,14066,6338,7728,10202,0.0071707664398009165,2
27199,1.35434216792763,103.68685754938303,WESTERN WATER CATCHMENT,70426,18488,51938,44457,0.031247869399551986,9
27189,1.35607204234326,103.68903921690323,WESTERN WATER CATCHMENT,13846,1215,12631,7530,0.005292675092305518,1
27179,1.35618418171977,103.6917825773122,WESTERN WATER CATCHMENT,23229,4174,19055,13701,0.009630138305402113,2
27169,1.35693103245165,103.69424464254188,WESTERN WATER CATCHMENT,12301,2130,10171,7215,0.0050712683653365625,1
22481,1.3424622384747,103.70554089546958,JURONG WEST,7244,55116,-47872,31180,0.0012809525356964867,167
97099,1.37318166697573,103.97643861099502,PASIR RIS,15138,964,14174,8051,0.0007591568163767409,55
97089,1.3708213292446,103.98008108137569,CHANGI,14103,2566,11537,8334,0.002659689051904148,4
97079,1.36810642046998,103.97758382793815,CHANGI,52608,6086,46522,29347,0.0093657180953001,17
97069,1.3651566598248,103.9752874368773,PASIR RIS,5927,694,5233,3310,0.0003121114224577087,22
97209,1.36229421254534,103.97331639977371,PASIR RIS,10271,1098,9173,5684,0.0005359641466010925,38
97059,1.36075141209876,103.97097232582753,CHANGI,34228,28574,5654,31401,0.010021225812196081,18
97049,1.35817903735465,103.96973879358464,CHANGI,37346,31108,6238,34227,0.010923107412949756,20
97039,1.35535232677111,103.96894056406585,CHANGI,42193,21494,20699,31843,0.010162284434819268,18
97019,1.3529227886583,103.96544071070835,PASIR RIS,130505,43540,86965,87022,0.008205607312723481,595
96069,1.34665000850794,103.96311235602505,TAMPINES,63209,34635,28574,48922,0.002041931511441695,530
96059,1.34351280089212,103.96217940266345,TAMPINES,26661,12580,14081,19620,0.0008189096164197305,212
96049,1.3408744614671,103.96143293297968,TAMPINES,38185,153549,-115364,95867,0.004001345983553023,1039
96099,1.33666533266027,103.95786100711895,TAMPINES,2573,1768,805,2170,9.057257225437386e-05,23
96089,1.33646502628787,103.95594670662865,TAMPINES,8556,3794,4762,6175,0.00025773531505564914,66
96079,1.33542124082545,103.95353854906277,TAMPINES,26230,5927,20303,16078,0.000671071804933559,174
84059,1.32493504095045,103.93953481204565,BEDOK,298722,175079,123643,236900,0.009647611324332778,1294
84029,1.32295305994698,103.92517704260585,BEDOK,221253,216489,4764,218871,0.00891339104334335,1196
84019,1.32221972730517,103.92262015530929,BEDOK,126369,48796,77573,87582,0.003566724757314113,478
83099,1.32076378388187,103.91810427638708,BEDOK,62504,76092,-13588,69298,0.002822119753286673,378
83079,1.31976833302337,103.91505416701378,BEDOK,22487,21157,1330,21822,0.0008886879456293369,119
83059,1.31888900641724,103.91222670426201,BEDOK,101131,72136,28995,86633,0.0035280772978510833,473
83049,1.318489754773,103.91002178191968,BEDOK,44856,26598,18258,35727,0.001454960784231478,195
83011,1.31971491091921,103.90725404505461,BEDOK,53106,74945,-21839,64025,0.0026073799706222292,349
83031,1.32027026937212,103.91000032422843,BEDOK,33653,47201,-13548,40427,0.0016463654833634496,220
83062,1.32096859171096,103.9133277893385,BEDOK,426578,282431,144147,354504,0.014436964140655413,1937
83081,1.32138694232025,103.91736615804473,BEDOK,82512,96663,-14151,89587,0.0036483771874757306,489
84011,1.32257749632692,103.92233358172962,BEDOK,247000,314603,-67603,280801,0.011435453387437605,1534
84021,1.32338320435233,103.92508721683168,BEDOK,275239,233242,41997,254240,0.010353772490917542,1389
84051,1.32520077474542,103.93890484697742,BEDOK,108771,222044,-113273,165407,0.0067361015041110675,904
96071,1.33552793998608,103.9532750845244,TAMPINES,2933,40226,-37293,21579,0.0009006753625240247,234
96081,1.33650217158472,103.95548614472102,TAMPINES,6128,8154,-2026,7141,0.00029805471818824137,77
96091,1.33683617019201,103.95794150619416,TAMPINES,1480,2855,-1375,2167,9.044735671669501e-05,23
96041,1.34155179676505,103.96123674713529,TAMPINES,146761,43726,103035,95243,0.00397530115171582,1033
96051,1.34372664222741,103.96192069089285,TAMPINES,12695,26557,-13862,19626,0.0008191600474950882,212
96061,1.34695398893694,103.96294329979929,TAMPINES,28780,68829,-40049,48804,0.0020370063669596598,529
97011,1.35332331548207,103.96595966764757,PASIR RIS,42977,141819,-98842,92398,0.008712529067144219,632
97031,1.35474723326023,103.96851979269732,CHANGI,5876,35472,-29596,20674,0.0065978415477641415,12
97041,1.35785139360852,103.96938267040976,PASIR RIS,4233,31015,-26782,17624,0.0016618283109953648,120
97051,1.36044412865764,103.9703768491515,PASIR RIS,17933,15631,2302,16782,0.0015824331999049145,114
97201,1.36265900778926,103.97370278833513,CHANGI,1770,10104,-8334,5937,0.0018947172907553306,3
97061,1.36590356071338,103.975349664689,PASIR RIS,699,6042,-5343,3370,0.00031776903132401155,23
97071,1.36855806171082,103.97786417344932,CHANGI,7158,57893,-50735,32525,0.010379935974703913,19
97081,1.37137551310062,103.97986770359047,CHANGI,1049,12532,-11483,6790,0.0021669412841887645,4
97091,1.37304817069239,103.97614190842204,PASIR RIS,832,18929,-18097,9880,0.0009316195933178736,67
96139,1.34646413372668,103.95585291875304,TAMPINES,44358,48503,-4145,46430,0.0019379191381431236,503
96149,1.34448666696732,103.95318111098746,TAMPINES,11965,82197,-70232,47081,0.001965090909819436,510
96159,1.34192167463909,103.9517629482475,TAMPINES,13810,43209,-29399,28509,0.0011899232545621863,309
96169,1.34226222202581,103.95346611100372,TAMPINES,395832,211400,184432,303616,0.012672480229301371,3293
96171,1.34223585449884,103.9559270984333,TAMPINES,12136,21255,-9119,16695,0.000696824467182844,181
96291,1.34193564484603,103.95772034392319,TAMPINES,18295,67655,-49360,42975,0.001793712577249639,466
96449,1.33980186622645,103.96388189995498,TAMPINES,1342,4483,-3141,2912,0.00012154254857361138,31
96419,1.338026,103.964172,TAMPINES,2174,11503,-9329,6838,0.0002854079488826767,74
96381,1.3332723569143,103.96209564305455,TAMPINES,6488,31398,-24910,18943,0.0007906526434168683,205
96321,1.33208271659156,103.96532458873912,TAMPINES,1169,20215,-19046,10692,0.00044626817628744947,115
96331,1.33124389066562,103.96761886176331,TAMPINES,9487,28460,-18973,18973,0.0007919047987936568,205
96341,1.33276553471842,103.97037694441909,TAMPINES,9966,13872,-3906,11919,0.0004974813311981023,129
96351,1.33529647913206,103.97039204168856,TAMPINES,32174,42929,-10755,37551,0.001567322885126264,407
96391,1.336856,103.967921,TAMPINES,1999,4150,-2151,3074,0.0001283041876082697,33
96371,1.33433369984263,103.9664670131305,TAMPINES,7637,3654,3983,5645,0.0002356139033990509,61
96329,1.33202391003542,103.96526335898176,TAMPINES,19392,493,18899,9942,0.000414964291867735,107
96389,1.33316035695047,103.96219500000879,TAMPINES,36002,2731,33271,19366,0.0008083080342295873,210
96411,1.338128,103.964,TAMPINES,8178,756,7422,4467,0.00018644593560381936,48
96441,1.33954269927544,103.96290652054516,TAMPINES,3146,374,2772,1760,7.345978210492995e-05,19
96299,1.34126498344514,103.95716526054423,TAMPINES,47461,14840,32621,31150,0.0013001546662321408,337
96179,1.3426613811598,103.95530716615029,TAMPINES,10499,10075,424,10287,0.00042936407870080364,111
96161,1.34211893867102,103.95354015150029,TAMPINES,154277,275046,-120769,214661,0.008959630844560437,2328
96151,1.34232997550862,103.95121028080379,TAMPINES,37181,14352,22829,25766,0.0010754345146111507,279
96141,1.34470972121071,103.95324349664256,TAMPINES,60918,10539,50379,35728,0.001491233576730078,387
96131,1.34639164071686,103.95526044455801,TAMPINES,36975,23931,13044,30453,0.0012710629229780862,330
15139,1.29241000003008,103.7845849999835,QUEENSTOWN,63599,17640,45959,40619,0.0035274589304050475,338
15129,1.28916467783169,103.78401870729115,QUEENSTOWN,929,27701,-26772,14315,0.0012431515938045807,119
15119,1.28703802671813,103.78501111787651,QUEENSTOWN,448,7742,-7294,4095,0.00035562038257979446,34
15109,1.28591970870508,103.78581066082835,QUEENSTOWN,15,159,-144,87,7.555304831365596e-06,0
15099,1.28305620100972,103.78789349372825,QUEENSTOWN,1859,4428,-2569,3143,0.00027294624235611574,26
15079,1.28077893732919,103.78682778221345,QUEENSTOWN,6557,12414,-5857,9485,0.0008237019117873872,79
15071,1.28142472197061,103.78701416697068,QUEENSTOWN,12932,7389,5543,10160,0.0008823206561686719,84
15091,1.28290732015735,103.78781105381566,QUEENSTOWN,2538,1729,809,2133,0.00018523523224485996,17
15101,1.28617611097876,103.78562083299963,QUEENSTOWN,96,54,42,75,6.513193820142755e-06,0
15111,1.28676277798099,103.78484166701072,QUEENSTOWN,6875,1859,5016,4367,0.0003792415655008455,36
15121,1.2889414210404,103.78373044277906,QUEENSTOWN,26700,1567,25133,14133,0.001227346243467701,117
15131,1.29254343742409,103.78448903561744,QUEENSTOWN,10090,34240,-24150,22165,0.0019248658803128556,184
29159,1.32532489846553,103.73750501985307,JURONG EAST,1285,8669,-7384,4977,0.00048538808274243,38
20249,1.32162000001571,103.73670359829424,JURONG EAST,7684,30815,-23131,19249,0.001877282540628699,147
20129,1.32034555007728,103.73754105423453,JURONG EAST,44987,47284,-2297,46135,0.004499372955057666,353
84609,1.33791138898959,103.93130805598769,BEDOK,24417,29291,-4874,26854,0.0010936131469127582,146
84639,1.33857139776249,103.92937717202952,BEDOK,44251,63301,-19050,53776,0.0021899955533023195,293
84619,1.33896501379939,103.92746694275839,BEDOK,18882,42899,-24017,30890,0.00125797684174183,168
84629,1.33815749250804,103.92537872720727,BEDOK,64617,80143,-15526,72380,0.002947632366632362,395
84479,1.33742106440195,103.92253160478627,BEDOK,145432,201487,-56055,173459,0.007064014405687798,948
84469,1.3375152915469,103.9197283469228,BEDOK,66068,71090,-5022,68579,0.0027928389067598887,374
84491,1.33463946695939,103.91413940065628,BEDOK,102825,141886,-39061,122355,0.004982834460062208,668
72079,1.33201510811169,103.91201112281274,BEDOK,148716,71634,77082,110175,0.004486811218481907,602
72069,1.33150994155892,103.90977961908514,BEDOK,226354,177438,48916,201896,0.008222094284244367,1103
72029,1.33086398684,103.90655207721196,BEDOK,52608,54310,-1702,53459,0.0021770859172119293,292
60051,1.3141464005633,103.86571468040536,KALLANG,74612,61562,13050,68087,0.0069144931277532505,354
60059,1.31434638899368,103.86586250001177,KALLANG,51711,76965,-25254,64338,0.006533767956487855,334
72021,1.33096531210116,103.9063218660858,BEDOK,55936,112625,-56689,84280,0.0034322527750728854,460
72061,1.33177922756641,103.9098393917043,BEDOK,159808,221897,-62089,190852,0.007772333965688305,1043
72071,1.33219165087886,103.91184110459187,BEDOK,61975,130875,-68900,96425,0.003926850662510714,527
84499,1.33520779235718,103.91401580602559,BEDOK,156759,100685,56074,128722,0.005242126740779923,703
84461,1.33807138901241,103.91939027798064,BEDOK,36225,46853,-10628,41539,0.0016916510206899929,227
84471,1.3373330466218,103.92199745160043,BEDOK,215250,173450,41800,194350,0.007914787931127376,1062
84621,1.33831497804809,103.9249204585602,BEDOK,90615,47490,43125,69052,0.002812101549885298,377
84611,1.33922469822607,103.92795482353951,BEDOK,30986,23621,7365,27303,0.0011118984043404722,149
84631,1.33879275233871,103.92948245969215,BEDOK,34254,28336,5918,31295,0.0012744702253904361,171
84601,1.33820137485609,103.93116966665325,BEDOK,23708,21961,1747,22834,0.0009299010425488167,124
62049,1.34904000002665,103.88022749996824,SERANGOON,43134,72707,-29573,57920,0.005881938366791259,687
62039,1.3467680506898,103.880911959518,HOUGANG,21643,46306,-24663,33974,0.001786478815234425,406
62029,1.34411328094155,103.88273473175272,HOUGANG,34055,36852,-2797,35453,0.0018642501158681953,424
62019,1.34215709944082,103.88405276089232,HOUGANG,49710,61535,-11825,55622,0.0029248108748151287,665
71151,1.32814305145316,103.8944494102938,GEYLANG,54253,56534,-2281,55393,0.003699765743173487,206
71141,1.32917333299413,103.89706805602555,GEYLANG,18337,27294,-8957,22815,0.0015238415581481975,85
71131,1.33127510693644,103.90140378909662,GEYLANG,65313,90838,-25525,78075,0.005214724069797086,291
71139,1.33054224737538,103.90087888738246,GEYLANG,138315,99931,38384,119123,0.007956369841388899,444
71149,1.32886553888796,103.89713767691656,GEYLANG,27633,27591,42,27612,0.0018442390139639725,103
71159,1.32787641919412,103.89457489895001,GEYLANG,38142,52181,-14039,45161,0.0030163580367096538,168
62011,1.3421349999944,103.88345100001618,SERANGOON,60057,44673,15384,52365,0.005317812544492822,621
62021,1.3436889743392,103.8825074871872,HOUGANG,32038,25538,6500,28788,0.0015137797178126986,344
62031,1.34521001044775,103.88171014272702,HOUGANG,42137,32632,9505,37384,0.001965789251448865,447
62041,1.3483829232168,103.88018488884609,SERANGOON,61654,34603,27051,48128,0.0048875333169359405,571
62051,1.35170429575719,103.87775496869286,SERANGOON,121132,94408,26724,107770,0.010944345610999549,1279
66351,1.35049831450162,103.87324486521683,SERANGOON,969964,630134,339830,800049,0.08124721872259978,9497
84641,1.32460611097515,103.92299333298999,BEDOK,86467,111535,-25068,99001,0.004031756727396663,541
84559,1.32833305090006,103.92287121813423,BEDOK,83622,115576,-31954,99599,0.0040561099210309004,544
84569,1.3279697494091,103.92011115886494,BEDOK,109465,103477,5988,106471,0.004335968025804286,581
84579,1.32584772443012,103.91948961283839,BEDOK,114008,62889,51119,88448,0.0036019920912392805,483
84589,1.32311277295983,103.91954371811282,BEDOK,29516,15890,13626,22703,0.0009245661456155638,124
84381,1.33078667404046,103.92426011381585,BEDOK,43571,86827,-43256,65199,0.0026551904210011515,356
84391,1.33274999618407,103.92447655289592,BEDOK,124797,115847,8950,120322,0.004900041746586613,657
84449,1.33322170084132,103.93155200621871,BEDOK,40967,89458,-48491,65212,0.00265571983825407,356
84501,1.33319499998844,103.91598944400951,BEDOK,96649,123946,-27297,110297,0.004491779595778524,602
84511,1.33206972200071,103.91329416702288,BEDOK,110358,96001,14357,103179,0.0042019032876037645,563
84549,1.32720168851924,103.92512088883021,BEDOK,49490,54543,-5053,52016,0.002118320602138007,284
84649,1.32477805597156,103.92314916696681,BEDOK,25010,45197,-20187,35103,0.0014295487560914036,191
84661,1.31992811557233,103.94438908816849,BEDOK,43069,183307,-140238,113188,0.004609513847946722,618
84671,1.31759333301805,103.94509555597209,BEDOK,24678,66504,-41826,45591,0.0018566663059841947,249
84681,1.32021834435842,103.94705927934717,BEDOK,15533,16349,-816,15941,0.0006491877252899486,87
84691,1.32111805602717,103.94595750002355,BEDOK,9527,5414,4113,7470,0.00030421129840762286,40
84541,1.32761801937398,103.92519155563974,BEDOK,76181,58784,17397,67482,0.002748164235494405,368
60069,1.32335935195255,103.87256741522513,GEYLANG,34086,26010,8076,30048,0.00200694241241451,112
60079,1.32685601711017,103.86950969695144,KALLANG,18623,28726,-10103,23674,0.0024041845037441867,123
60071,1.32719924782732,103.87028217319148,GEYLANG,43919,48485,-4566,46202,0.003085887690973615,172
60061,1.32276521075674,103.87402134422791,GEYLANG,19037,37578,-18541,28307,0.0018906589080210838,105
52161,1.34093830148518,103.84540645330499,TOA PAYOH,60005,111333,-51328,85669,0.006465306287555457,787
52281,1.33444611098518,103.85362416699164,TOA PAYOH,33227,47745,-14518,40486,0.0030554154986981315,372
52291,1.3369700601272,103.85224710756584,TOA PAYOH,68407,90300,-21893,79353,0.005988647583564512,729
52169,1.34013183349101,103.84465978021645,TOA PAYOH,52625,24288,28337,38456,0.0029022145536218777,353
52351,1.33836800687246,103.85328005892127,TOA PAYOH,22607,80483,-57876,51545,0.0038900210413573876,473
52341,1.33625777803173,103.85562250002782,TOA PAYOH,88486,144805,-56319,116645,0.008803016866216557,1072
52311,1.33435800960389,103.85721839168514,TOA PAYOH,67605,206739,-139134,137172,0.010352157654187129,1261
52429,1.33630975081569,103.85712939407202,TOA PAYOH,139358,38739,100619,89048,0.006720314166083862,818
52439,1.33825111098581,103.85541166702772,TOA PAYOH,67601,22897,44704,45249,0.00341487170628345,416
52359,1.33862833298637,103.85268888900069,TOA PAYOH,41060,15343,25717,28201,0.00212828564142632,259
52339,1.33287166703192,103.8558608329901,TOA PAYOH,71157,225185,-154028,148171,0.011182235090095362,1362
52309,1.33390300713051,103.85467626312281,TOA PAYOH,18467,36088,-17621,27277,0.0020585527974605776,250
52229,1.33775023417492,103.8488028810671,TOA PAYOH,21157,27834,-6677,24495,0.0018485995811048444,225
52551,1.33634,103.839853,TOA PAYOH,17525,33671,-16146,25598,0.001931841276877804,235
52559,1.336478,103.83967,TOA PAYOH,106360,90154,16206,98257,0.007415303083919931,903
52221,1.33801162125737,103.8482286336101,TOA PAYOH,23624,20987,2637,22305,0.0016833236846925314,205
52299,1.33715967694295,103.85231928852072,TOA PAYOH,39933,40117,-184,40025,0.0030206245451611102,368
52289,1.33501934336797,103.85386490982448,TOA PAYOH,44483,25223,19260,34853,0.0026303017432229903,320
52301,1.33411036071703,103.85462603898891,TOA PAYOH,43528,21728,21800,32628,0.002462384451205914,300
52331,1.33246306626276,103.85581029367948,TOA PAYOH,247254,79098,168156,163176,0.012314639120080184,1500
52489,1.33536277799489,103.85871194397946,TOA PAYOH,39934,159839,-119905,99886,0.0075382411822101855,918
52399,1.33696449411474,103.859733895085,TOA PAYOH,25268,91731,-66463,58499,0.0044148286138008695,537
52389,1.33972612917249,103.85808211459384,TOA PAYOH,36849,116494,-79645,76671,0.005786241211793816,705
52529,1.34132643517011,103.85733489917507,TOA PAYOH,7066,39407,-32341,23236,0.001753584807779227,213
52539,1.33991805598004,103.85386250003322,TOA PAYOH,111451,104655,6796,108053,0.008154591979470167,993
52371,1.33992964917756,103.85651585657361,TOA PAYOH,58267,28194,30073,43230,0.0032625009141115506,397
52381,1.33988664001033,103.8583063045366,TOA PAYOH,69615,23186,46429,46400,0.0035017358874572272,426
52391,1.3376513888146,103.8598834966415,TOA PAYOH,88074,25094,62980,56584,0.0042703065399974085,520
52481,1.33524833301564,103.85859277800392,TOA PAYOH,188201,68880,119321,128540,0.009700714029606724,1182
52319,1.33412138901702,103.85712611102798,TOA PAYOH,76503,18821,57682,47662,0.003596977066120396,438
21411,1.34393270141852,103.71033048575686,JURONG WEST,10155,61137,-50982,35646,0.0014644270072943222,191
21431,1.34765638897246,103.71241055602675,JURONG WEST,133206,135383,-2177,134294,0.005517134054805131,721
21441,1.34638242521451,103.71326229185901,JURONG WEST,230342,173498,56844,201920,0.008295379602560443,1085
21459,1.3455804550235,103.71491332975407,JURONG WEST,101204,35928,65276,68566,0.002816863103353602,368
21239,1.34450482589547,103.71633035405124,JURONG WEST,12712,11923,789,12317,0.0005060132258554723,66
21629,1.33954476976732,103.7227567243868,JURONG WEST,2843,11072,-8229,6957,0.00028581099393330524,37
21609,1.33775166774993,103.72102625466782,JURONG WEST,85456,246023,-160567,165739,0.006808973454579859,890
21599,1.33468356164521,103.72268493639599,JURONG WEST,128994,376180,-247186,252587,0.010376906931814256,1357
21589,1.33246568746472,103.72345805167676,JURONG WEST,35196,136992,-101796,86094,0.0035369572677438526,462
21579,1.33013472279057,103.72318086110512,JURONG WEST,28823,151267,-122444,90045,0.00369927424877454,484
21569,1.32857203912272,103.72289813113439,JURONG WEST,58534,207326,-148792,132930,0.005461097516681654,714
21561,1.32889315236799,103.72274321247575,JURONG WEST,229582,83800,145782,156691,0.006437258940693335,842
21571,1.33056719470166,103.72307005592994,JURONG WEST,111940,24848,87092,68394,0.0028097969123292337,367
21581,1.33243350969467,103.72328639029729,JURONG WEST,172201,49139,123062,110670,0.004546600934109371,594
21591,1.33476103645994,103.72242808341083,JURONG WEST,346345,145284,201061,245814,0.010098655118976787,1321
21601,1.33727029608815,103.72109770581518,JURONG WEST,189220,57188,132032,123204,0.005061529063757214,662
21621,1.3392149977089,103.72205929003123,JURONG WEST,34391,9009,25382,21700,0.0008914903792371316,116
21231,1.34359535075913,103.71599040338819,JURONG WEST,9271,31986,-22715,20628,0.0008474499328526981,110
21451,1.34524833302487,103.71473000001441,JURONG WEST,39655,104160,-64505,71907,0.002954119755751356,386
21449,1.34639805597018,103.71306138901696,JURONG WEST,265627,452740,-187113,359183,0.014756137736660397,1930
21439,1.34842277796612,103.71165888901649,JURONG WEST,64205,67825,-3620,66015,0.0027120616306607944,354
21419,1.34388060681347,103.71057645840757,JURONG WEST,81283,22401,58882,51842,0.002129799273751676,278
27271,1.34199989028017,103.69132051378558,JURONG WEST,77212,289738,-212526,183475,0.007537612780208881,986
27131,1.34193999997072,103.6885297219715,JURONG WEST,131808,223103,-91295,177455,0.007290296094355999,953
27531,1.34052795177305,103.68697304819686,JURONG WEST,120593,141222,-20629,130907,0.005377987607133418,703
27141,1.33967546710179,103.68779973857258,JURONG WEST,161155,158366,2789,159760,0.006563341151471158,858
27159,1.34033777802121,103.69005138898682,JURONG WEST,81382,32386,48996,56884,0.0023369372687799535,305
27279,1.34210239034142,103.69119289371211,JURONG WEST,284518,30974,253544,157746,0.006480600984476523,847
22411,1.34626796042608,103.70380100924208,JURONG WEST,14065,60276,-46211,37170,0.0015270367463706995,199
27331,1.34537305600812,103.69941138898014,JURONG WEST,38719,101881,-63162,70300,0.0028881001686806612,377
27341,1.34663703411498,103.69778819793345,JURONG WEST,97021,118867,-21846,107944,0.004434610022874329,580
27429,1.34286500004293,103.69555805555355,JURONG WEST,39445,13785,25660,26615,0.001093410896009044,143
22419,1.34622597800485,103.70286134292765,JURONG WEST,11727,7976,3751,9851,0.0004047037661688932,52
27391,1.34842706557746,103.6963119899037,JURONG WEST,38663,85357,-46694,62010,0.0025475261943085034,333
27409,1.34719000000045,103.69416749997193,JURONG WEST,78631,117012,-38381,97821,0.0040187318150855045,525
27419,1.34575472199235,103.6928200000021,JURONG WEST,72837,64411,8426,68624,0.002819245888699028,368
22239,1.34081972201603,103.69742194398371,JURONG WEST,119270,38014,81256,78642,0.0032308104333625114,422
22231,1.34079486676221,103.69717899290252,JURONG WEST,35600,119224,-83624,77412,0.003180278951037089,416
27411,1.34590833297224,103.69273749998102,JURONG WEST,74869,116256,-41387,95562,0.003925926434131741,513
27401,1.34736600563095,103.6941379590552,JURONG WEST,106251,53016,53235,79633,0.003271523196764539,428
27399,1.34866469760279,103.69640367719292,JURONG WEST,99667,44096,55571,71881,0.0029530516105965095,386
21359,1.33867010260834,103.7099597309989,JURONG WEST,10549,8914,1635,9731,0.00039977386545421786,52
21251,1.33624121368399,103.71034741400833,JURONG WEST,5214,27362,-22148,16288,0.0006691518570052719,87
21269,1.33418183646412,103.71049761773749,JURONG WEST,4504,24056,-19552,14280,0.0005866581850463705,76
21509,1.33115639068272,103.70998723220183,JURONG WEST,13124,38440,-25316,25782,0.0010591891685480057,138
21499,1.3265554895957,103.71102434826084,BOON LAY,17188,18436,-1248,17812,0.02376159431600039,0
21489,1.326155,103.712199,BOON LAY,3333,4281,-948,3807,0.005078620568213198,0
21479,1.3269180560083,103.71570166699784,BOON LAY,5884,17245,-11361,11564,0.015426626806098614,0
21469,1.32747500002724,103.71808527797025,BOON LAY,12694,7125,5569,9909,0.01321882091159038,0
21671,1.33806500003375,103.72376166703002,JURONG WEST,24214,43635,-19421,33924,0.0013936829320387305,182
21409,1.34338969264048,103.71207059648545,JURONG WEST,14861,8899,5962,11880,0.0004880601707528628,63
21679,1.3377621978639,103.72358362464975,JURONG WEST,20541,15878,4663,18209,0.0007480713509460335,97
21461,1.32731972199567,103.71799361099863,BOON LAY,6271,9039,-2768,7655,0.010211936025655906,0
21471,1.32673138898791,103.71542666702132,BOON LAY,16772,4330,12442,10551,0.014075262835623182,0
21481,1.325953,103.711932,BOON LAY,5503,11778,-6275,8640,0.011525947388852648,0
21491,1.3268635454851,103.71082676692178,BOON LAY,17230,4256,12974,10743,0.014331394999819906,0
21501,1.3304277146486,103.71000208357827,JURONG WEST,42863,10548,32315,26705,0.0010971083215450506,143
21261,1.33393514008105,103.71025085451481,JURONG WEST,22533,5755,16778,14144,0.000581070964236405,76
21259,1.33604134949327,103.71043700168366,JURONG WEST,32283,4463,27820,18373,0.0007548088819227565,98
21351,1.33882138642125,103.70956429008974,JURONG WEST,1931,12738,-10807,7334,0.00030129909867857707,39
25491,1.33901033639652,103.63816647849173,TUAS,581,74,507,327,0.0002112089289059119,0
25471,1.33552353410516,103.64184123007807,TUAS,2042,5724,-3682,3883,0.0025080252933995595,0
25501,1.33379055380717,103.6436358584241,TUAS,4291,2410,1881,3350,0.0021637611982715747,0
25531,1.332349,103.645156,TUAS,2878,1097,1781,1987,0.001283401045064364,0
25541,1.329782,103.647851,TUAS,23642,2418,21224,13030,0.008416062212978692,0
25551,1.325522,103.645927,TUAS,9630,480,9150,5055,0.0032650187633620326,0
24701,1.321386,103.649116,TUAS,111176,41400,69776,76288,0.04927433262499758,3
26011,1.31922965607898,103.64876709883725,TUAS,2928,160,2768,1544,0.0009972678478003913,0
26021,1.3172613938167,103.64693086349153,TUAS,264,325,-61,294,0.00018989426635577402,0
26031,1.31548257210498,103.64524684749753,TUAS,234,1498,-1264,866,0.000559348417224831,0
26049,1.31486576449382,103.64275148813714,TUAS,12,1350,-1338,681,0.00043985712717102755,0
26059,1.31672777803073,103.64083888900358,TUAS,96,3801,-3705,1948,0.0012582109893232917,0
26069,1.31850277800807,103.63897555599392,TUAS,199,19369,-19170,9784,0.006319474496683309,0
25561,1.31836,103.637711,TUAS,99,964,-865,531,0.00034297229739767347,0
25571,1.315444,103.635242,TUAS,483,26064,-25581,13273,0.008573015637211525,0
25591,1.310246,103.63509,TUAS,446,15475,-15029,7960,0.005141354966639324,0
25601,1.301632,103.634717,TUAS,50,18707,-18657,9378,0.006057239557430098,0
25611,1.297703,103.633033,TUAS,167,7275,-7108,3721,0.002403389677244337,0
25621,1.294382,103.631889,TUAS,663,1958,-1295,1310,0.0008461275133539591,0
25631,1.290329,103.631397,TUAS,628,1860,-1232,1244,0.0008034981882536832,0
25661,1.293361,103.639925,TUAS,114,1325,-1211,719,0.0004644012840469439,0
25671,1.294546,103.641614,TUAS,2474,2505,-31,2489,0.0016076422753725221,0
25669,1.293396,103.639523,TUAS,743,50,693,396,0.0002557759506016548,0
25641,1.296157,103.638434,TUAS,6913,1746,5167,4329,0.002796096187258999,0
25651,1.299345,103.63553,TUAS,16316,213,16103,8264,0.005337708221646654,0
25609,1.301942,103.634519,TUAS,4615,52,4563,2333,0.001506882052408234,0
25599,1.30943,103.635806,TUAS,12508,188,12320,6348,0.004100165996008345,0
25579,1.315542,103.634947,TUAS,24259,620,23639,12439,0.008034335983671677,0
25569,1.318191,103.637247,TUAS,1505,108,1397,806,0.0005205944853154893,0
26061,1.318186,103.639406,TUAS,16529,178,16351,8353,0.005395193220645511,0
26051,1.316385,103.641295,TUAS,11896,77,11819,5986,0.003866350606821984,0
26041,1.314711,103.643052,TUAS,841,15,826,428,0.000276444714286637,0
26039,1.316062,103.645623,TUAS,1638,57,1581,847,0.0005470763387868728,0
26029,1.317805,103.647257,TUAS,221,266,-45,243,0.00015695342423283364,0
26019,1.318612,103.648062,TUAS,229,1908,-1679,1068,0.0006898199879862812,0
24709,1.32089,103.649026,TUAS,89139,136599,-47460,112869,0.07290195901125801,5
25559,1.325651,103.645879,TUAS,458,9411,-8953,4934,0.0031868650006781937,0
25589,1.328334,103.648426,TUAS,1309,10144,-8835,5726,0.0036984169018815034,0
25549,1.329815,103.647687,TUAS,2191,23965,-21774,13078,0.008447065358506166,0
25539,1.332311,103.64507,TUAS,1167,4685,-3518,2926,0.0018899000794455605,0
25509,1.33355930464673,103.64364939022576,TUAS,2353,3917,-1564,3135,0.0020248929422631004,0
25479,1.33552805597987,103.64162972197275,TUAS,5261,1990,3271,3625,0.0023413833861893906,0
25499,1.33874972198024,103.63823777800012,TUAS,32,569,-537,300,0.00019376965954670818,0
25691,1.328519,103.639669,TUAS,113469,2308,111161,57888,0.03738979350613281,2
26101,1.326868,103.638144,TUAS,282,647,-365,464,0.000299697073432242,0
26091,1.324656,103.636135,TUAS,197,4875,-4678,2536,0.0016379995220348398,0
26081,1.322491,103.634908,TUAS,391,12354,-11963,6372,0.0041156675687720815,0
26071,1.320508,103.637024,TUAS,1475,5162,-3687,3318,0.0021430924345865925,0
25701,1.295593,103.627651,TUAS,4076,20159,-16083,12117,0.007826356549091543,0
25711,1.288627,103.625073,TUAS,2033,14195,-12162,8114,0.005240823391873301,0
25741,1.280501,103.62711,TUAS,2371,2597,-226,2484,0.0016044127810467437,0
25751,1.278059,103.621663,TUAS,1377,4779,-3402,3078,0.001988076706949226,0
25761,1.275062,103.624222,TUAS,8454,5873,2581,7163,0.004626573571110236,0
25771,1.274334,103.632329,TUAS,30255,53509,-23254,41882,0.027051536270450774,1
25781,1.276398,103.635811,TUAS,31662,11945,19717,21803,0.014082532956989595,0
25791,1.28207,103.636168,TUAS,6933,3791,3142,5362,0.0034633097149648307,0
25801,1.28451,103.634186,TUAS,8662,2933,5729,5797,0.0037442757213075576,0
25729,1.284932,103.628258,TUAS,5929,521,5408,3225,0.002083023840127113,0
25719,1.289014,103.624893,TUAS,18088,1805,16283,9946,0.006424110112838532,0
25709,1.295671,103.627284,TUAS,16655,3758,12897,10206,0.006592043817779012,0
26079,1.32060611102859,103.6367552779852,TUAS,6949,1904,5045,4426,0.0028587483771791013,0
26089,1.32215171578031,103.63510021174817,TUAS,11867,386,11481,6126,0.0039567764479437805,0
26099,1.32464249366642,103.63599686578979,TUAS,4690,370,4320,2530,0.0016341241288439056,0
26109,1.32727742846476,103.63849052734983,TUAS,1543,4165,-2622,2854,0.0018433953611543504,0
25059,1.270007,103.61725,TUAS,1030,1791,-761,1410,0.0009107173998695285,0
21349,1.33506459808859,103.70924473268514,JURONG WEST,737,2428,-1691,1582,6.499252442180378e-05,8
21339,1.33042465634522,103.70832322685169,JURONG WEST,313,14099,-13786,7206,0.0002960405379162567,38
21329,1.32691548284142,103.70901792785014,BOON LAY,174,37454,-37280,18814,0.025098284047902052,0
21319,1.32377340235344,103.70980422080449,BOON LAY,1259,15456,-14197,8357,0.011148419251000182,0
21309,1.3191903081711,103.71054697877872,BOON LAY,137,18307,-18170,9222,0.012302348011573972,0
21299,1.316014,103.709922,BOON LAY,635,18512,-17877,9573,0.01277058962424611,0
22079,1.31394399203055,103.70804979014268,BOON LAY,719,11220,-10501,5969,0.007962775458803409,0
22069,1.31365447950552,103.70379462205501,BOON LAY,1141,38784,-37643,19962,0.026629740946328306,0
22059,1.3136061110111,103.70126249997799,BOON LAY,760,19624,-18864,10192,0.013596349049442846,0
22049,1.3144663889863,103.69788888900642,BOON LAY,56,2408,-2352,1232,0.001643514720262322,0
22399,1.31345707127095,103.69601603244551,BOON LAY,1887,57554,-55667,29720,0.03964712458295147,0
22409,1.31014256556667,103.69741989860339,BOON LAY,121,17348,-17227,8734,0.011651345427573961,0
22429,1.30725749703402,103.69908070609895,BOON LAY,346,7354,-7008,3850,0.0051359835008197565,0
22089,1.30589277802592,103.70087805599307,BOON LAY,608,11922,-11314,6265,0.008357645878606695,0
22331,1.30485847664917,103.70317916961058,BOON LAY,6518,4447,2071,5482,0.007313106896491923,0
22081,1.30599555710248,103.70037593299399,BOON LAY,12420,595,11825,6507,0.00868047912722965,0
22421,1.30775500000365,103.69872388898081,BOON LAY,2841,184,2657,1512,0.0020170407930492134,0
22099,1.30879764761052,103.69688960154522,BOON LAY,381,1840,-1459,1110,0.0014807640742623192,0
23469,1.3050852014562,103.69683459275382,BOON LAY,2216,7214,-4998,4715,0.006289912261393546,0
23451,1.30402666700212,103.6972844439932,BOON LAY,3524,2284,1240,2904,0.0038739989834754734,0
23461,1.30546916761511,103.69643466903611,BOON LAY,4429,125,4304,2277,0.0030375673847705415,0
22091,1.30880721630907,103.6965558745042,BOON LAY,7392,2259,5133,4825,0.006436654647131253,0
22401,1.31007875279152,103.69714966993958,BOON LAY,29261,1348,27913,15304,0.020415867921180664,0
22391,1.31342749923518,103.6957230721563,BOON LAY,67637,2504,65133,35070,0.04678414061655815,0
22041,1.31463499997457,103.69873083298778,BOON LAY,8044,212,7832,4128,0.005506841530229598,0
22051,1.31386916701697,103.7020447220124,BOON LAY,34230,408,33822,17319,0.023103921623557757,0
22061,1.31427617763344,103.70464097156747,BOON LAY,12307,201,12106,6254,0.008342971640032924,0
22071,1.31433636827053,103.70695129035255,BOON LAY,8325,169,8156,4247,0.0056655901111640275,0
21291,1.31585422996408,103.70943351671639,BOON LAY,17838,1257,16581,9547,0.012735905060344471,0
21301,1.31849721492889,103.70997054139839,BOON LAY,15573,223,15350,7898,0.010536103295967386,0
21311,1.32320514106483,103.70956380845345,BOON LAY,7676,368,7308,4022,0.005365435231245989,0
21321,1.32624055798556,103.70885429370763,BOON LAY,26322,415,25907,13368,0.017833201932197014,0
21331,1.33029049207675,103.70796785261548,JURONG WEST,14946,223,14723,7584,0.00031156972516748415,40
21341,1.33517345758852,103.70895825573741,JURONG WEST,4144,605,3539,2374,9.75298691386613e-05,12
63249,1.36395805601148,103.89261277802149,HOUGANG,266532,312641,-46109,289586,0.015227504979939842,3465
71061,1.33901443022109,103.89506854137488,HOUGANG,20698,50984,-30286,35841,0.0018846525936544718,428
71071,1.33638181561906,103.89785574766542,BEDOK,104227,154733,-50506,129480,0.005272995839065463,707
71081,1.33375855817569,103.9005998503616,BEDOK,118675,163559,-44884,141117,0.00574690572923541,771
84679,1.31804305599346,103.94476555602924,BEDOK,69853,10110,59743,39981,0.0016282023991479478,218
84669,1.31994111212465,103.94418156021838,BEDOK,157332,23892,133440,90612,0.003690119701648129,495
71089,1.33291479894363,103.90097214917817,GEYLANG,166990,108483,58507,137736,0.009199554716331366,513
71079,1.33554558497215,103.89825312082961,GEYLANG,153724,98800,54924,126262,0.008433192321494969,471
22569,1.33464939590143,103.70458203446965,JURONG WEST,2203,2290,-87,2246,9.22713083763409e-05,12
22559,1.33465462202129,103.70101403397047,JURONG WEST,2579,3434,-855,3006,0.00012349401290261833,16
22549,1.33463563122766,103.69795361380136,JURONG WEST,5508,17099,-11591,11303,0.00046435556481646536,60
22159,1.32095243330175,103.69663318172152,BOON LAY,170,43514,-43344,21842,0.029137701720754576,0
22149,1.3173196040118,103.69631182452453,PIONEER,499,73755,-73256,37127,0.01691763412853702,1
23279,1.3149287594586,103.69162853660083,BOON LAY,710,4745,-4035,2727,0.003637877144606617,0
23269,1.312406285462,103.6857799047387,BOON LAY,5385,13862,-8477,9623,0.01283729070867234,0
23259,1.31139556205987,103.6836649596919,BOON LAY,1797,5720,-3923,3758,0.005013253505475492,0
23439,1.30774277950908,103.68468656882482,BOON LAY,74,1290,-1216,682,0.0009098027915737854,0
23429,1.30456833652112,103.68472051252805,BOON LAY,7882,9118,-1236,8500,0.011339184352459203,0
23419,1.30380777799126,103.6861461109867,BOON LAY,3762,2603,1159,3182,0.0042448570128853155,0
23409,1.30352138897737,103.68933638897875,BOON LAY,8992,8860,132,8926,0.011907477591770688,0
23399,1.30533638898993,103.69237083299343,BOON LAY,3949,3883,66,3916,0.0052240289322623805,0
23389,1.30755644701044,103.69377301234816,BOON LAY,3097,3674,-577,3385,0.0045156634156558115,0
22141,1.3173330063793,103.6959517251446,PIONEER,47509,341,47168,23925,0.010901888020180682,0
22151,1.32095233702714,103.69627164313702,PIONEER,38282,356,37926,19319,0.008803075220976828,0
22541,1.33496804809618,103.69761016575693,JURONG WEST,18689,14955,3734,16822,0.0006910899151855773,90
22551,1.33498204269222,103.70065616150622,JURONG WEST,5537,3527,2010,4532,0.00018618591699090693,24
22561,1.33497038465954,103.704144267721,JURONG WEST,259,1053,-794,656,2.695012390689209e-05,3
22439,1.33311257526168,103.70680944659455,JURONG WEST,727,30478,-29751,15602,0.0006409692579197109,83
22309,1.33326999997395,103.7033808329889,JURONG WEST,3747,33646,-29899,18696,0.0007680785313464245,100
22299,1.33068833434452,103.70177410483808,JURONG WEST,2129,21143,-19014,11636,0.0004780360392996895,62
22281,1.32849264291843,103.70375258407391,JURONG WEST,1376,9603,-8227,5489,0.0002255018751904431,29
22219,1.32764556072381,103.70260743188996,BOON LAY,5044,14240,-9196,9642,0.012862637120754309,0
22229,1.32764334311,103.69887468380779,BOON LAY,6793,14176,-7383,10484,0.013985883382492032,0
23189,1.32764459746447,103.69397532297509,PIONEER,23230,16212,7018,19721,0.008986254279873908,0
23179,1.32767284372911,103.69102029335356,PIONEER,6866,3877,2989,5371,0.002447399814269193,0
23169,1.32768833297607,103.68867638901021,PIONEER,14279,1650,12629,7964,0.0036289503110854314,0
23159,1.32766374044406,103.68563350571777,PIONEER,13320,2181,11139,7750,0.003531437080727285,0
23499,1.32755092355685,103.67805103515069,PIONEER,135234,73262,61972,104248,0.04750261326343974,3
24149,1.32754011144327,103.67466321781171,PIONEER,403,4972,-4569,2687,0.001224383411085705,0
24139,1.32733592150747,103.67193012673827,PIONEER,1827,16977,-15150,9402,0.00428420276554812,0
24129,1.32614180600676,103.66987144292962,PIONEER,10945,46837,-35892,28891,0.013164741767650577,1
24571,1.32367555849755,103.6690675022225,PIONEER,18018,31166,-13148,24592,0.011205819443773598,0
24581,1.3249613889807,103.666995833031,PIONEER,31096,42608,-11512,36852,0.016792325070833794,1
24599,1.32562284433654,103.66926644008088,PIONEER,13439,1448,11991,7443,0.0033915466054004104,0
24489,1.32574395668742,103.67111058135133,PIONEER,9684,1718,7966,5701,0.0025977706835130644,0
24499,1.32598700998791,103.67439565139507,PIONEER,4507,2326,2181,3416,0.0015565663313244394,0
24159,1.3268422233348,103.67664244711858,PIONEER,1860,1922,-62,1891,0.0008616706476974574,0
23491,1.32792408366339,103.67780864699097,PIONEER,61798,79479,-17681,70638,0.032187568065601795,2
23151,1.32788229015066,103.68483459543562,JURONG WEST,1807,13513,-11706,7660,0.0003146919956201119,41
23161,1.3278839556405,103.68869472049072,JURONG WEST,1960,15477,-13517,8718,0.00035815728692116647,46
23171,1.32789603640425,103.69118969248986,JURONG WEST,2551,8021,-5470,5286,0.00021716212648145058,28
23181,1.32790305599387,103.69448861100467,JURONG WEST,12089,20021,-7932,16055,0.0006595796331176105,86
22221,1.32790916071437,103.69785686002558,JURONG WEST,8692,2140,6552,5416,0.00022250285225568222,29
22271,1.32924582821916,103.7001114570651,JURONG WEST,14020,3246,10774,8633,0.0003546652739149381,46
22289,1.32926333300758,103.70284000001512,JURONG WEST,20341,1275,19066,10808,0.00044401972436842937,58
22329,1.33024346855102,103.70501590196446,JURONG WEST,6332,705,5627,3518,0.00014452825595189994,18
22319,1.33198138900019,103.70545250001828,JURONG WEST,19346,1047,18299,10196,0.00041887723072358494,54
22431,1.33308242562379,103.70742208599415,JURONG WEST,24033,804,23229,12418,0.0005101625589569908,66
23471,1.31966340928848,103.68097194774356,PIONEER,74,23095,-23021,11584,0.005278473179760628,0
23191,1.31966145615591,103.68362765144359,PIONEER,196,17889,-17693,9042,0.004120161817282079,0
23201,1.31964589958011,103.68628552653574,PIONEER,30,18096,-18066,9063,0.004129730872597597,0
23211,1.31792061914698,103.6892047185557,PIONEER,731,20345,-19614,10538,0.004801843091187629,0
23249,1.30990348653039,103.67948846644917,PIONEER,613,1642,-1029,1127,0.0005135393019328581,0
23281,1.30650617564734,103.6789673712784,PIONEER,2252,5561,-3309,3906,0.0017798442886865515,0
23291,1.30382409549165,103.67930477414359,PIONEER,3192,2812,380,3002,0.0013679192408184914,0
23301,1.30212057066579,103.67953903241491,PIONEER,17259,16499,760,16879,0.007691242127173656,0
23311,1.30178638897679,103.67745555601714,PIONEER,10164,7452,2712,8808,0.004013535200909152,0
23321,1.30404333032775,103.67618479236954,PIONEER,7883,8358,-475,8120,0.003700034722000716,0
23331,1.30689333299079,103.67584222201577,PIONEER,8089,4739,3350,6414,0.0029226628949399745,0
23241,1.3102543597714,103.67981162071217,PIONEER,1071,141,930,606,0.0002761355962478367,0
23251,1.3117223561773,103.68378143028161,PIONEER,4033,163,3870,2098,0.0009559941929504314,0
23261,1.31264863196713,103.68577338809426,BOON LAY,7715,135,7580,3925,0.005236035127459102,0
23219,1.31832727349422,103.68852528629336,PIONEER,24808,778,24030,12793,0.005829377364354084,0
23209,1.31950327084795,103.68577614249959,PIONEER,11831,12,11819,5921,0.0026980179296756455,0
23199,1.31951264524841,103.68312351699183,PIONEER,13593,234,13359,6913,0.003150041876008738,0
23479,1.31950924526288,103.68065985334341,PIONEER,16317,27,16290,8172,0.0037237295256391445,0
23239,1.30916000001419,103.67513000000729,PIONEER,1740,38671,-36931,20205,0.009206798221431585,0
23229,1.30868757581216,103.67180644651505,PIONEER,446,19190,-18744,9818,0.004473761194655546,0
24339,1.30840666698801,103.66899333300486,PIONEER,478,5032,-4554,2755,0.0012553689235359573,0
24679,1.30929393064989,103.6612549652211,PIONEER,1346,9170,-7824,5258,0.0023959091832856856,0
24689,1.31152436181276,103.65889588893424,PIONEER,131,5006,-4875,2568,0.0011701587642977635,0
24699,1.31345305601187,103.65690250002406,TUAS,528,3721,-3193,2124,0.0013718891895906939,0
24601,1.31333999996651,103.65486500001047,TUAS,742,8525,-7783,4633,0.00299244944226633,0
24611,1.31085562935941,103.65254056553094,TUAS,1935,10391,-8456,6163,0.003980674705954541,0
24621,1.30797138899535,103.64977944402521,TUAS,5654,7701,-2047,6677,0.004312666722644568,0
24629,1.3085113890287,103.65015527797974,TUAS,6189,185,6004,3187,0.0020584796832511967,0
24619,1.31113971951498,103.65260471956782,TUAS,5946,62,5884,3004,0.0019402801909277046,0
24609,1.3134310373537,103.65475166394909,TUAS,8330,199,8131,4264,0.002754112761023879,0
25821,1.317492,103.652589,TUAS,3991,3029,962,3510,0.0022671050166964855,0
26141,1.32668624650782,103.6402558570377,TUAS,831,3508,-2677,2169,0.0014009546385227,0
26151,1.32452998769194,103.64252271521323,TUAS,18596,28769,-10173,23682,0.015296176924617143,1
26161,1.32238325656852,103.6448005401494,TUAS,899,2887,-1988,1893,0.0012226865517397285,0
26171,1.32013250000852,103.64712138903367,TUAS,686,2362,-1676,1524,0.0009843498704972776,0
26131,1.31902277799591,103.64969999999403,TUAS,2096,12622,-10526,7359,0.004753169748680752,0
26121,1.31736840181558,103.65136419209274,TUAS,2349,1812,537,2080,0.0013434696395238433,0
26111,1.31464305600075,103.6542583329887,TUAS,2648,2412,236,2530,0.0016341241288439056,0
24691,1.31344500002083,103.65712805602769,TUAS,8046,2012,6034,5029,0.0032482253928679847,0
24681,1.31200874931979,103.65863348470843,PIONEER,3435,20,3415,1727,0.0007869408823762607,0
24671,1.30957805602715,103.66123000003104,PIONEER,9664,252,9412,4958,0.002259208393063984,0
24331,1.30854833300657,103.66868333299611,PIONEER,4386,474,3912,2430,0.0011072764007957808,0
23221,1.30896659624814,103.67178095052478,PIONEER,14004,511,13493,7257,0.0033067921154629554,0
23231,1.30926499998419,103.67491833296833,PIONEER,31918,1500,30418,16709,0.007613778346048026,0
24639,1.32041012800861,103.67791569301414,PIONEER,259,21125,-20866,10692,0.004872016163501436,0
24259,1.32022430366593,103.6756285744157,PIONEER,164,35141,-34977,17652,0.008043474496644908,0
24249,1.3200141711372,103.67231073811735,PIONEER,4212,25730,-21518,14971,0.006821825101363636,0
24239,1.31979166699662,103.6690038889689,PIONEER,9098,29944,-20846,19521,0.008895120419726106,0
24229,1.31953778109044,103.66615348821185,PIONEER,11394,19434,-8040,15414,0.007023686601591015,0
24219,1.31822701576325,103.66267154250265,PIONEER,1962,5468,-3506,3715,0.0016928114522454015,0
24209,1.31523764085318,103.65986932009741,PIONEER,3689,7308,-3619,5498,0.0025052698154630466,0
24199,1.31308152323838,103.65993666344218,PIONEER,3762,5770,-2008,4766,0.0021717198873220955,0
24189,1.31116229073472,103.6619380811675,PIONEER,9041,10982,-1941,10011,0.004561705369698174,0
24179,1.30940312319597,103.66477126222463,PIONEER,5192,4743,449,4967,0.002263309416770635,0
24169,1.31038624703757,103.66671593002816,PIONEER,8830,8795,35,8812,0.004015357878112107,0
24301,1.31260985884793,103.66584908540896,PIONEER,3673,3622,51,3647,0.0016618259397951493,0
24641,1.31424000000651,103.66551388890647,PIONEER,8356,7844,512,8100,0.0036909213359859363,0
24651,1.31490027800406,103.66882611097928,PIONEER,13724,12401,1323,13062,0.005951952406252877,0
24089,1.31445576142607,103.67069001700851,PIONEER,12792,16113,-3321,14452,0.006585332734280093,0
24299,1.31215859373419,103.67165007095036,PIONEER,19154,11468,7686,15311,0.0069767526636148975,0
24289,1.31240457504935,103.674858525035,PIONEER,15377,12290,3087,13833,0.006303273437122649,0
24279,1.31480277476233,103.6767463061916,PIONEER,14208,1997,12211,8102,0.003691832674587414,0
24269,1.31796007151086,103.67660828077693,PIONEER,26871,839,26032,13855,0.006313298161738907,0
24631,1.32056657586424,103.67824444522353,PIONEER,28970,317,28653,14643,0.006672365570721242,0
23369,1.31907826658404,103.67911023430729,PIONEER,247,4518,-4271,2382,0.0010854042743603087,0
23359,1.31500500807478,103.6788828370567,PIONEER,397,23315,-22918,11856,0.005402415229561637,0
23449,1.31284166701008,103.67877583300174,PIONEER,478,20243,-19765,10360,0.004720733955656086,0
23349,1.31076855055702,103.67871579430353,PIONEER,45,3439,-3394,1742,0.0007937759218873458,0
24389,1.30668431065764,103.66551563876423,PIONEER,551,26129,-25578,13340,0.00607862847185832,0
24379,1.30366277967429,103.66588434674222,PIONEER,807,8452,-7645,4629,0.0021092931931208517,0
24369,1.30077687663858,103.66698326196405,PIONEER,3151,10056,-6905,6603,0.0030087843927796465,0
24359,1.29822556407932,103.66853349337183,PIONEER,861,16773,-15912,8817,0.004017636224615802,0
24349,1.29557792043984,103.67091644467769,PIONEER,508,8546,-8038,4527,0.0020628149244454734,0
24341,1.29559624794118,103.67069575266142,PIONEER,7989,631,7358,4310,0.0019639346861851092,0
24351,1.29811763317717,103.6683905248493,PIONEER,8196,673,7523,4434,0.0020204376794767456,0
24461,1.29723931495896,103.66626018526829,PIONEER,18902,17986,916,18444,0.008404364582830198,0
24391,1.29859319877639,103.66447101698635,PIONEER,422,274,148,348,0.00015857291665717356,0
24401,1.30031638897466,103.66355777798681,PIONEER,491,461,30,476,0.00021689858715176613,0
24411,1.30243777798816,103.66173361100701,PIONEER,966,1383,-417,1174,0.0005349557590675913,0
24421,1.30463277796645,103.65950611101405,PIONEER,4784,5134,-350,4959,0.002259664062364723,0
24531,1.30622638897168,103.65688416696948,PIONEER,1982,13812,-11830,7897,0.0035984204679359185,0
24541,1.30275657598845,103.6556555059217,PIONEER,3412,10865,-7453,7138,0.0032525674686750138,0
24559,1.30079305601761,103.6574800000263,PIONEER,5645,3958,1687,4801,0.0021876683128479605,0
24549,1.30273638896787,103.65543583300811,PIONEER,18601,640,17961,9620,0.004383538673109223,0
24539,1.30492020241064,103.65548029310382,PIONEER,7719,1137,6582,4428,0.002017703663672312,0
24431,1.30726611103183,103.6576999999841,PIONEER,9833,692,9141,5262,0.0023977318604886414,0
24441,1.30713498253909,103.66096830094709,PIONEER,1531,232,1299,881,0.00040144465395106294,0
24451,1.30599340060276,103.66378722029442,PIONEER,17612,649,16963,9130,0.004160260715747111,0
24381,1.3068880559927,103.66532722200753,PIONEER,13027,862,12165,6944,0.003164167624331647,0
23341,1.31118496429579,103.67850804808974,PIONEER,5019,107,4912,2563,0.0011678804177940685,0
23441,1.31304186906391,103.67862695881058,PIONEER,18040,358,17682,9199,0.004191701897498102,0
23351,1.31615485867639,103.67874941599844,PIONEER,3778,239,3539,2008,0.000914983955883921,0
23361,1.31910770453777,103.6788383227952,PIONEER,4559,117,4442,2338,0.0010653548251277924,0
23039,1.32303111111252,103.68151388887642,PIONEER,2930,863,2067,1896,0.0008639489942011525,0
23029,1.32302194442237,103.68622888892132,PIONEER,1025,1623,-598,1324,0.0006033061541784419,0
23019,1.32302099996901,103.69256700002227,PIONEER,9161,2471,6690,5816,0.00265017265309805,0
27421,1.3428341669778,103.69536361096887,JURONG WEST,1706,18631,-16925,10168,0.00041772692055682737,54
23011,1.32240518497889,103.69250829071932,PIONEER,12865,24513,-11648,18689,0.008516003561511255,0
23021,1.32243595181684,103.6851860612218,PIONEER,2312,3377,-1065,2844,0.0012959234913017287,0
23031,1.32239543114794,103.68099108399514,PIONEER,16673,9384,7289,13028,0.00593645965002775,0
60181,1.32714561804071,103.86738538742665,KALLANG,18040,22655,-4615,20347,0.002066315033272069,105
82033,1.31798449318919,103.898237229405,GEYLANG,67965,87305,-19340,77635,0.005185335935429994,289
84581,1.3238068248883,103.91945047474212,BEDOK,1667,37341,-35674,19504,0.0007942887769936113,106
84571,1.32653228537615,103.9187401751097,BEDOK,8719,48681,-39962,28700,0.0011687903968271454,156
84561,1.32804725721627,103.91973825722668,BEDOK,41881,50127,-8246,46004,0.0018734854848653658,251
84551,1.32853887137542,103.9225201285922,BEDOK,54561,43400,11161,48980,0.0019946813113795674,267
54389,1.36638973614786,103.85660537812751,ANG MO KIO,210916,265889,-54973,238402,0.014143889253326975,2295
54379,1.36288998904353,103.85594804936484,ANG MO KIO,180398,277215,-96817,228806,0.013574578755617536,2202
54609,1.3593577779887,103.85529250000319,ANG MO KIO,71587,66438,5149,69012,0.004094336814081263,664
54369,1.35874638898802,103.85588277797046,ANG MO KIO,40485,27162,13323,33823,0.0020066474535250472,325
54371,1.36238306289968,103.85568284134345,ANG MO KIO,294740,208632,86108,251686,0.014932001034441209,2423
54381,1.3657416739059,103.85608617430734,ANG MO KIO,159887,151646,8241,155766,0.009241269173218889,1499
54619,1.36467168386173,103.84050288513411,BISHAN,5475,28367,-22892,16921,0.002220321617936199,193
54629,1.3655880696456,103.83801666007233,BISHAN,9648,44413,-34765,27030,0.0035467935306905895,309
54181,1.37053305192374,103.83653495602837,ANG MO KIO,113874,257536,-143662,185705,0.011017487075566,1787
54169,1.37089833300275,103.83476694396748,ANG MO KIO,13810,44450,-30640,29130,0.0017282216338345097,280
56289,1.37023167757252,103.83232655288832,ANG MO KIO,5614,10027,-4413,7820,0.00046394415298955943,75
54621,1.36595331171712,103.83773071305599,ANG MO KIO,66308,16323,49985,41315,0.0024511320563636377,397
54611,1.36489470522366,103.84057417396242,ANG MO KIO,53475,17876,35599,35675,0.0021165227184018584,343
55009,1.38589831101442,103.84757704926118,ANG MO KIO,8549,13898,-5349,11223,0.0006658369858058601,108
55231,1.38576093943759,103.84831692135697,ANG MO KIO,68081,15595,52486,41838,0.002482160546390945,402
55319,1.38408669861968,103.84678260704942,ANG MO KIO,11119,8265,2854,9692,0.0005750059758024053,93
55309,1.38408333299371,103.84444749999892,ANG MO KIO,49089,50162,-1073,49625,0.002944146878786047,477
55159,1.38336200025306,103.8406500476486,ANG MO KIO,53660,48740,4920,51200,0.003037588316248778,492
56251,1.37637472203353,103.8344186109838,ANG MO KIO,36975,13501,23474,25238,0.0014973174594821613,242
56241,1.37199166697877,103.83320833301671,ANG MO KIO,25239,8224,17015,16731,0.0009926150413898105,161
54161,1.37107664581619,103.83482933088284,ANG MO KIO,27620,6784,20836,17202,0.0010205584807834271,165
54189,1.37046966291161,103.83679073259783,ANG MO KIO,233013,95424,137589,164218,0.009742708556987145,1581
54449,1.3746081045073,103.85088955053739,ANG MO KIO,20074,49058,-28984,34566,0.002050728080848735,332
54401,1.3729466814704,103.8516353477965,ANG MO KIO,15061,55779,-40718,35420,0.002101394104717416,341
54411,1.37235305596731,103.8542291670297,ANG MO KIO,51567,97144,-45577,74355,0.004411325766692927,715
54589,1.37173441613541,103.85671893941708,ANG MO KIO,158441,97774,60667,128107,0.00760031887557973,1233
54429,1.370344,103.85818,ANG MO KIO,43318,37211,6107,40264,0.0023887784368250152,387
54439,1.37328474238491,103.85715387505564,ANG MO KIO,70976,53445,17531,62210,0.0036907884600358683,598
54419,1.37206167776818,103.8548909469337,ANG MO KIO,74683,11683,63000,43183,0.0025619565675892766,415
54409,1.37270833297137,103.85213888899418,ANG MO KIO,49071,14555,34516,31813,0.0018873983809535619,306
54441,1.37418169489017,103.85076922983178,ANG MO KIO,35641,13482,22159,24561,0.0014571524733473873,236
56249,1.37295831920319,103.83301111771881,ANG MO KIO,9176,16083,-6907,12629,0.000749252008709098,121
56259,1.376844443968,103.83484027799092,ANG MO KIO,10313,41745,-31432,26029,0.0015442458258523328,250
55151,1.3833944010563,103.8403312479222,ANG MO KIO,56132,52990,3142,54561,0.0032369893773994056,525
55301,1.38425166698696,103.84445666701023,ANG MO KIO,36147,47724,-11577,41935,0.002487915352380713,403
55311,1.38430357836038,103.84683966636786,ANG MO KIO,6364,22619,-16255,14491,0.0008597205525539266,139
55239,1.38699777800655,103.84804111102198,ANG MO KIO,21435,40666,-19231,31050,0.0018421311956938388,298
55229,1.38851043039698,103.84591573293089,ANG MO KIO,14813,13462,1351,14137,0.0008387184770861127,136
55219,1.38560725163314,103.8459306339141,ANG MO KIO,30942,482,30460,15712,0.0009321599145488437,151
55149,1.38147638900431,103.8392680559805,ANG MO KIO,48245,52750,-4505,50497,0.002995880804797159,486
55139,1.37894011617745,103.84007487448596,ANG MO KIO,139817,69249,70568,104533,0.006201723036375654,1006
54209,1.37638119735545,103.83952322759048,ANG MO KIO,151595,48696,102899,100145,0.005941392225209645,964
54199,1.37430000000968,103.83767277798232,ANG MO KIO,174041,106389,67652,140215,0.008318661050055125,1349
54511,1.37167638225112,103.86344756349828,SERANGOON,5010,15809,-10799,10409,0.0010570631294877454,123
54521,1.37342640743158,103.86288750616447,SERANGOON,1647,21349,-19702,11498,0.0011676541322749635,136
54599,1.37489472202166,103.86180138897765,SERANGOON,1180,18677,-17497,9928,0.0010082162311033083,117
54641,1.37573967362754,103.864609061163,SERANGOON,30848,33604,-2756,32226,0.00327264063895399,382
54631,1.37702166744619,103.86697522711312,SERANGOON,30297,65099,-34802,47698,0.0048438656115195,566
54591,1.37530666700034,103.8617738890253,SERANGOON,14241,1022,13219,7631,0.00077494944193688,90
54529,1.3733597291276,103.86303621815655,SERANGOON,29557,4071,25486,16814,0.0017075088345861226,199
54519,1.37121805600151,103.86373555598497,SERANGOON,19576,9289,10287,14432,0.0014656100571397003,171
54191,1.37447193336668,103.83756404776227,ANG MO KIO,82694,187959,-105265,135326,0.008028606962591446,1302
54201,1.37608498575075,103.83927614239282,ANG MO KIO,57912,99577,-41665,78744,0.004671715905755738,758
55131,1.37986282047018,103.8396597025406,ANG MO KIO,65571,130851,-65280,98211,0.005826652072795092,945
55141,1.38151305598601,103.83902055596755,ANG MO KIO,34619,30110,4509,32364,0.0019200880520913173,311
55211,1.38603759468682,103.8455676081697,ANG MO KIO,528,41962,-41434,21245,0.0012604211675528376,204
55221,1.38779002795173,103.84621115886938,ANG MO KIO,7250,11793,-4543,9521,0.0005648609054493089,91
55199,1.3795247679563,103.8426631996752,ANG MO KIO,22867,40289,-17422,31578,0.0018734563252051544,304
55169,1.38123639226093,103.84100233602071,ANG MO KIO,100409,115941,-15532,108175,0.006417795236527569,1041
64579,1.37820828048176,103.89268060309126,HOUGANG,95173,30277,64896,62725,0.0032983129359386385,750
67209,1.38690839585967,103.89618101813248,SENGKANG,92112,70907,21205,81509,0.006299195438124039,771
67249,1.39376571527248,103.89850423466406,SENGKANG,62659,44402,18257,53530,0.00413691655894171,506
67259,1.39465386086721,103.90046238900585,SENGKANG,166326,77978,88348,122152,0.009440176191067583,1156
67251,1.39442862205324,103.9003121852631,SENGKANG,68762,159199,-90437,113980,0.008808625992680293,1078
67241,1.39299612191324,103.89844142173672,SENGKANG,39924,56363,-16439,48143,0.0037205973079979587,455
67201,1.38669709800422,103.89628892246895,SENGKANG,79739,96015,-16276,87877,0.006791328534468908,831
64571,1.37811157042732,103.89296494237695,HOUGANG,30355,75626,-45271,52990,0.002786410561584511,634
76399,1.3586225675181,103.94723337005571,TAMPINES,45292,65164,-19872,55228,0.002305134571642654,599
76369,1.36025642698418,103.95022273065783,TAMPINES,51817,125434,-73617,88625,0.0036990756755962595,961
76359,1.36209168075863,103.95217875196944,TAMPINES,101208,209244,-108036,155226,0.006478902350579464,1683
76279,1.3618856073242,103.95504580030337,TAMPINES,91339,131968,-40629,111653,0.004660230142819173,1211
76269,1.36187820405808,103.95739818627865,TAMPINES,67235,77636,-10401,72435,0.0030233291572560233,785
76259,1.35967015846114,103.95842446373796,TAMPINES,44145,65306,-21161,54725,0.0022841400998251655,593
76429,1.35369222069272,103.9595890045465,TAMPINES,51811,39719,12092,45765,0.0019101630272909769,496
62101,1.34324887065522,103.87308054810315,TOA PAYOH,139,1031,-892,585,4.41490408224672e-05,5
62109,1.34374111656683,103.87380734555013,SERANGOON,5525,2440,3085,3982,0.00040438326271689904,47
76421,1.35384124345467,103.95987193850509,TAMPINES,144293,215943,-71650,180118,0.007517857405213508,1953
76251,1.35970826873107,103.95823716945422,TAMPINES,57387,42196,15191,49791,0.002078202278856004,540
76261,1.36164005637877,103.95740032197719,TAMPINES,79476,70166,9310,74821,0.003122917248223275,811
76271,1.36181167182029,103.95518343875231,TAMPINES,111011,70608,40403,90809,0.0037902325870264684,985
76351,1.36213822350227,103.95309131019367,TAMPINES,217581,112517,105064,165049,0.0068888997594526045,1790
76361,1.36002524992852,103.95032266084807,TAMPINES,147121,52124,94997,99622,0.004158074098214393,1080
76391,1.35844376751138,103.947541136035,TAMPINES,74639,49830,24809,62234,0.002597554590635347,675
17221,1.31735631283972,103.76790022594946,CLEMENTI,80481,64330,16151,72405,0.006740706915403918,294
17269,1.30513563161538,103.76274177899958,CLEMENTI,28526,82029,-53503,55277,0.005146137092228194,224
17279,1.30292494255611,103.76319287727786,CLEMENTI,37885,79012,-41127,58448,0.005441348495152659,237
17289,1.30232494247638,103.7647147428673,CLEMENTI,12774,22313,-9539,17543,0.0016332051849586484,71
17211,1.31828806129678,103.7658972301256,CLEMENTI,14302,46485,-32183,30393,0.002829504941369675,123
17201,1.32055715133061,103.76734890374861,CLEMENTI,196129,204862,-8733,200495,0.0186655346040178,814
17219,1.31820000002277,103.76615861100824,CLEMENTI,35418,11010,24408,23214,0.00216115973115374,94
20341,1.31186472196722,103.75047333297755,CLEMENTI,47584,68675,-21091,58129,0.005411650470071326,236
20331,1.31329138901596,103.74926333296754,CLEMENTI,34605,38541,-3936,36573,0.0034048459915346665,148
20329,1.31503304622752,103.75102066090028,CLEMENTI,32398,30712,1686,31555,0.0029376839543618625,128
20319,1.31259468493848,103.75284421307401,CLEMENTI,51798,17938,33860,34868,0.0032461151678240983,141
20309,1.31062303116794,103.75403766163392,CLEMENTI,30197,6879,23318,18538,0.0017258369559803584,75
76349,1.3603851367314,103.95556569101933,TAMPINES,18142,41988,-23846,30065,0.001254868380104954,326
76319,1.357643,103.955554,TAMPINES,14393,29056,-14663,21724,0.0009067274468451694,235
98081,1.36189974501014,103.96453090144483,PASIR RIS,2799,9120,-6321,5959,0.0005618948539049806,40
97101,1.36321195503241,103.96739806471844,PASIR RIS,561,8061,-7500,4311,0.00040649919704386164,29
97111,1.36331111102284,103.97038833297182,PASIR RIS,3890,12931,-9041,8410,0.0007930081760934532,57
99071,1.38768333301182,103.97832722200666,CHANGI,915,3901,-2986,2408,0.000768482269856634,1
99081,1.38939876912039,103.97862661282434,CHANGI,2478,2428,50,2453,0.0007828434418431575,1
99091,1.39096634300286,103.97976929995467,CHANGI,424,444,-20,434,0.00013850552538113752,0
99101,1.39138333298306,103.98170083301015,CHANGI,3919,6822,-2903,5370,0.001713766523725135,3
99111,1.39175111102446,103.98415750002044,CHANGI,1679,3601,-1922,2640,0.000842522089876044,1
99129,1.3900050122734,103.98675461297464,CHANGI,11111,2443,8668,6777,0.0021627925011704356,4
99119,1.39154974647967,103.98437037471184,CHANGI,1840,921,919,1380,0.0004404092742533866,0
99109,1.39120638899594,103.98181999999792,CHANGI,5895,3284,2611,4589,0.0014645204054701386,2
99099,1.39085926684364,103.97992778639245,CHANGI,313,254,59,283,9.031581493746986e-05,0
99089,1.38909485885165,103.97849220206042,CHANGI,2355,2815,-460,2585,0.0008249695463369597,1
99079,1.38759303713073,103.9791471471214,CHANGI,2293,653,1640,1473,0.0004700890296922018,0
97119,1.36337227349683,103.96996378901376,PASIR RIS,9134,4290,4844,6712,0.0006328978451770817,45
97109,1.36281875953495,103.96702623375789,PASIR RIS,5038,452,4586,2745,0.0002588356056333566,18
98089,1.36163640696695,103.96414293864342,PASIR RIS,2981,1906,1075,2443,0.0002303589743396321,16
76311,1.35791501506433,103.95535655821823,TAMPINES,13045,34196,-21151,23620,0.0009858636666582076,256
76341,1.35976305104284,103.95535006454477,TAMPINES,35799,14841,20958,25320,0.0010568191380095605,274
75129,1.35563642049496,103.93936521711959,TAMPINES,102804,68068,34736,85436,0.0035659715590436337,926
75139,1.35563964372785,103.93612503756641,TAMPINES,73933,138408,-64475,106170,0.0044313778784547805,1151
75161,1.35324997143303,103.93456070784656,TAMPINES,43159,118804,-75645,80981,0.00338002648559053,878
75201,1.35078500992301,103.93353377368994,TAMPINES,30026,71751,-41725,50888,0.0021239894271339065,552
75081,1.34986941891093,103.93426738811776,TAMPINES,205471,175208,30263,190339,0.007944466742085377,2064
75099,1.34810640028821,103.93423427925954,TAMPINES,32811,30270,2541,31540,0.0013164326861303925,342
75219,1.34971138040971,103.9321567318492,TAMPINES,27189,23378,3811,25283,0.0010552748130448545,274
75109,1.35115140327554,103.93102423699943,TAMPINES,33477,80331,-46854,56904,0.0023750883186925763,617
75111,1.35304499998303,103.93201333297846,TAMPINES,77366,22949,54417,50157,0.002093478574452825,544
75169,1.35327639994383,103.93440612457627,TAMPINES,128466,49500,78966,88983,0.0037140180630926035,965
75131,1.35594818346107,103.93709646027764,TAMPINES,187881,57661,130220,122771,0.00512427892545702,1331
75121,1.35593392058986,103.93903255460283,TAMPINES,101911,108874,-6963,105392,0.004398905315683396,1143
76151,1.355263,103.946998,TAMPINES,42421,17038,25383,29729,0.0012408442398849219,322
76401,1.35501333299594,103.95086166698833,TAMPINES,7546,56346,-48800,31946,0.001333378522229598,346
76181,1.35384110037439,103.95308027923268,TAMPINES,45013,122134,-77121,83573,0.003488212710145063,906
76189,1.3537000000187,103.95279611102576,TAMPINES,144704,96289,48415,120496,0.005029323809383886,1307
76409,1.35484670853897,103.9507954515594,TAMPINES,38621,10660,27961,24640,0.0010284369494690194,267
76159,1.35517831738683,103.94720149012322,TAMPINES,14548,36500,-21952,25524,0.0010653337945717228,276
76291,1.3488330441336,103.95120760822915,TAMPINES,5628,31310,-25682,18469,0.0007708685884636086,200
76301,1.34907001187678,103.95354386528878,TAMPINES,22265,63553,-41288,42909,0.0017909578354207041,465
76329,1.34644501660314,103.94989623103628,TAMPINES,31987,23562,8425,27774,0.0011592454478308663,301
76339,1.34547166699324,103.94698416699394,TAMPINES,30314,20879,9435,25596,0.0010683389674760154,277
75079,1.34858249441921,103.9370121634589,TAMPINES,36178,64850,-28672,50514,0.0021083792234366087,547
75089,1.34977145890473,103.93404731779178,TAMPINES,186335,211857,-25522,199096,0.008309970896569962,2159
75141,1.35625000000112,103.93377888890949,TAMPINES,140957,107215,33742,124086,0.005179165069472919,1346
75329,1.35775471736024,103.93627195175705,TAMPINES,38742,46190,-7448,42466,0.0017724676743567929,460
75339,1.35846309875614,103.93415212517196,TAMPINES,82283,64396,17887,73339,0.003061060772609919,795
75101,1.35109968413462,103.93150144928326,TAMPINES,69443,22956,46487,46199,0.0019282775417418516,501
75071,1.34893303477474,103.93654250213598,TAMPINES,60546,31546,29000,46046,0.00192189154932023,499
76371,1.35852839462785,103.95427534853701,TAMPINES,9198,16661,-7463,12929,0.0005396372288833178,140
76471,1.35855302099722,103.95134500001934,TAMPINES,32189,33710,-1521,32949,0.001375242250326896,357
76041,1.35122178461773,103.9365069000221,TAMPINES,16230,52319,-36089,34274,0.0014305457794683916,371
75419,1.35575831547919,103.92918587034406,PAYA LEBAR,25217,24901,316,25059,0.03528089982555954,0
75021,1.35168445182114,103.92851745350569,TAMPINES,23165,33884,-10719,28524,0.0011905493322505807,309
76049,1.35118252345739,103.93633200959248,TAMPINES,62461,15204,47257,38832,0.0016207899197151364,421
76161,1.35258745876643,103.94758343695361,TAMPINES,13451,13664,-213,13557,0.0005658490147707587,147
76171,1.35177947844792,103.95042351024047,TAMPINES,9760,33748,-23988,21754,0.000907979602221958,235
78211,1.36790255939851,103.96243675215658,PASIR RIS,33004,46785,-13781,39894,0.0037617441352047823,272
78201,1.37134689166636,103.96205663680765,PASIR RIS,46345,59732,-13387,53038,0.005001137650849532,362
77371,1.37466,103.948239,PASIR RIS,2562,6975,-4413,4768,0.00044959131790886855,32
77321,1.37313477197799,103.94802646457005,PASIR RIS,60000,64222,-4222,62111,0.005856662404915633,424
77069,1.37414972830656,103.94081177255107,PASIR RIS,12720,28633,-15913,20676,0.0019496120153279712,141
77301,1.37419765728407,103.93864478052231,PASIR RIS,21188,34309,-13121,27748,0.00261645551370287,189
77311,1.37581953068998,103.936865329717,PASIR RIS,54683,65546,-10863,60114,0.0056683583231488515,411
77161,1.37752492323898,103.93657565115056,PASIR RIS,10305,10282,23,10293,0.0009705628010142584,70
65161,1.39735631138291,103.90859112878573,PUNGGOL,62174,89173,-26999,75673,0.010284512399297794,1794
65171,1.39452041732154,103.91205304613206,PUNGGOL,142213,205397,-63184,173805,0.02362136663750549,4120
65231,1.3942824799683,103.91576531457447,PUNGGOL,52287,103373,-51086,77830,0.010577664425057118,1845
65269,1.39671015437474,103.91467219472072,PUNGGOL,112148,97836,14312,104992,0.014269178251517372,2489
65279,1.39929726136961,103.91103404530959,PUNGGOL,162988,84774,78214,123881,0.01683633106309265,2937
65271,1.400166,103.910274,PUNGGOL,92947,172076,-79129,132511,0.018009210980711086,3141
65261,1.39695155432601,103.91478844205221,PUNGGOL,90252,88302,1950,89277,0.012133395180211028,2116
65239,1.39410461413829,103.91603484855351,PUNGGOL,76427,29850,46577,53138,0.0072218416063045765,1259
65179,1.39429582834351,103.91190241454986,PUNGGOL,131609,105711,25898,118660,0.01612675909902708,2813
65169,1.39645725997371,103.90932129998102,PUNGGOL,106440,66774,39666,86607,0.011770522714389334,2053
77169,1.37694324707892,103.9363320444146,PASIR RIS,43757,39522,4235,41639,0.003926286259733091,284
77319,1.37554666701554,103.93754166696733,PASIR RIS,56642,43850,12792,50246,0.004737870251604238,343
77309,1.37437639672106,103.93874482147835,PASIR RIS,30374,20123,10251,25248,0.0023807218109402504,172
77061,1.37377216806532,103.94041320097696,PASIR RIS,24169,14888,9281,19528,0.0018413630990193762,133
77329,1.37283117687855,103.94765867700548,PASIR RIS,3009,9407,-6398,6208,0.0005853739307001375,42
77379,1.374679,103.948026,PASIR RIS,6465,3058,3407,4761,0.0004489312635411332,32
78209,1.3713650312338,103.96221418839181,PASIR RIS,60813,59592,1221,60202,0.005676656149486096,411
78219,1.36725694472542,103.96327818546209,PASIR RIS,28171,45031,-16860,36601,0.0034512357019258594,250
76179,1.35172938925372,103.95069571840816,TAMPINES,29520,15000,14520,22260,0.0009290992895771255,241
76169,1.3524530559991,103.9474516670289,TAMPINES,7401,14919,-7518,11160,0.0004658018001653513,121
20121,1.32023972200054,103.73707999997312,JURONG EAST,32395,27158,5237,29776,0.002903941240051958,228
20241,1.32116277513743,103.73638362986378,JURONG EAST,10922,1920,9002,6421,0.0006262159693166854,49
21611,1.3383643422738,103.71931958855112,JURONG WEST,69030,57677,11353,63353,0.002602699999806912,340
21619,1.33793509893342,103.71816213921478,JURONG WEST,42905,97980,-55075,70442,0.0028939338845263606,378
82111,1.3161193086354,103.89379978179137,GEYLANG,11459,21842,-10383,16650,0.0011120737209365545,62
44491,1.38353368663411,103.74184597655336,CHOA CHU KANG,39725,33987,5738,36856,0.003114655597143265,598
44501,1.38087128691259,103.73879787160988,CHOA CHU KANG,46602,189815,-143213,118208,0.00998961387093312,1918
44621,1.37922934454518,103.73710050197961,CHOA CHU KANG,116085,257038,-140953,186561,0.015766042512986887,3028
44569,1.37811996831753,103.74122138165869,CHOA CHU KANG,117834,50028,67806,83931,0.007092906417512247,1362
44579,1.37850611289436,103.74345256107138,CHOA CHU KANG,113826,43682,70144,78754,0.006655404463246709,1278
44521,1.38085185530408,103.74260886969472,CHOA CHU KANG,19129,40194,-21065,29661,0.0025066149247576076,481
44511,1.379843,103.741069,CHOA CHU KANG,30224,87048,-56824,58636,0.004955256826407979,951
44629,1.37851168892339,103.73644907938714,CHOA CHU KANG,234003,123416,110587,178709,0.015102479572115145,2900
44509,1.38081340360597,103.73845177601393,CHOA CHU KANG,227374,69288,158086,148331,0.01253527185206907,2407
44499,1.383205,103.740969,CHOA CHU KANG,64497,55412,9085,59954,0.005066639398500307,973
44571,1.37836352141036,103.74316666952303,CHOA CHU KANG,27173,84953,-57780,56063,0.004737815735365826,909
44561,1.3779870225601,103.7412004881177,CHOA CHU KANG,19104,64427,-45323,41765,0.0035295091983581633,677
44551,1.37602460873449,103.73843005883766,CHOA CHU KANG,100454,167837,-67383,134145,0.011336430298425855,2177
44581,1.37532277779344,103.74031352986161,CHOA CHU KANG,44953,64251,-19298,54602,0.004614348407727821,886
44181,1.37451449960262,103.74273111430522,CHOA CHU KANG,26199,36501,-10302,31350,0.002649350254244665,508
44189,1.37436129742622,103.74272235228217,CHOA CHU KANG,72595,83788,-11193,78191,0.006607826020084357,1269
44591,1.37543194866252,103.7419701443328,CHOA CHU KANG,75256,48419,26837,61837,0.005225769431315067,1003
45231,1.384581,103.742313,CHOA CHU KANG,49226,25655,23571,37440,0.0031640087246864513,607
45241,1.38849236327693,103.74049628403257,WESTERN WATER CATCHMENT,7353,18742,-11389,13047,0.009170455767504661,2
45251,1.39132771354143,103.74006551818796,WESTERN WATER CATCHMENT,413,17757,-17344,9085,0.006385651157184016,1
45311,1.39312896100059,103.74208908630851,CHOA CHU KANG,64063,85431,-21368,74747,0.006316777781627622,1213
45261,1.39431509144869,103.7435570382963,CHOA CHU KANG,116638,93766,22872,105202,0.008890492677736754,1707
45271,1.39569595459867,103.74526443744904,CHOA CHU KANG,24472,49955,-25483,37213,0.0031448252316174387,604
45321,1.39740269682477,103.74755489070483,CHOA CHU KANG,795833,459378,336455,627605,0.05303813289681732,10187
45389,1.40063804359533,103.7473817647614,CHOA CHU KANG,12213,45595,-33382,28904,0.002442641778267553,469
45401,1.40279972616248,103.74594266826703,CHOA CHU KANG,131437,194214,-62777,162825,0.013760142109964514,2642
45411,1.4035145178289,103.74767347957746,CHOA CHU KANG,232582,239684,-7102,236133,0.019955311757115006,3832
45421,1.40274884902867,103.75050925171398,CHOA CHU KANG,276800,304630,-27830,290715,0.02456796998924203,4718
45439,1.40127194398549,103.75115527801049,CHOA CHU KANG,184487,162887,21600,173687,0.01467807647875576,2819
45399,1.39984083299841,103.74991277803167,CHOA CHU KANG,38210,28344,9866,33277,0.002812198673381171,540
45329,1.39743803967229,103.7478650735721,CHOA CHU KANG,160344,595976,-435632,378160,0.0319578402598138,6138
45279,1.39565860027275,103.74540871067298,CHOA CHU KANG,52244,16140,36104,34192,0.0028895242071174986,554
45269,1.39436168074215,103.74373102471621,CHOA CHU KANG,90171,54690,35481,72430,0.006120970938275632,1175
45319,1.39292754317447,103.74210769996479,CHOA CHU KANG,67928,47485,20443,57706,0.004876663660971056,936
45259,1.39170172991756,103.74054217961515,CHOA CHU KANG,32594,7875,24719,20234,0.0017099506553233349,328
45249,1.38856706129182,103.74086222271667,CHOA CHU KANG,45227,30439,14788,37833,0.0031972206752420543,614
45239,1.38511352779283,103.74242558943692,CHOA CHU KANG,4003,52493,-48490,28248,0.0023872040185615086,458
44541,1.38764444400097,103.74593527798108,CHOA CHU KANG,29238,2361,26877,15799,0.0013351542158472555,256
45291,1.39086231015739,103.7449781608435,CHOA CHU KANG,5703,68174,-62471,36938,0.003121585317106521,599
45309,1.3919980495631,103.74665022024047,CHOA CHU KANG,84709,98331,-13622,91520,0.0077342435492335476,1485
45369,1.3925860608387,103.75002597798891,CHOA CHU KANG,108422,75943,32479,92182,0.00779018836161983,1496
45379,1.39469439744859,103.75187309514442,CHOA CHU KANG,36360,21500,14860,28930,0.0024448390065485853,469
45359,1.39618571003148,103.74944608386802,CHOA CHU KANG,27910,20913,6997,24411,0.002062943829549171,396
45339,1.39898191366295,103.74603555889117,CHOA CHU KANG,12550,9941,2609,11245,0.0009503012315464515,182
45349,1.39731214160283,103.74554806071029,CHOA CHU KANG,6877,3822,3055,5349,0.0004520374644323672,86
45351,1.39635349170474,103.74947902253896,CHOA CHU KANG,21838,9289,12549,15563,0.0013152101437578856,252
45371,1.39533587133451,103.75193731177454,CHOA CHU KANG,10717,19664,-8947,15190,0.001283688368803077,246
45361,1.39239930690933,103.7500200571186,CHOA CHU KANG,65374,83791,-18417,74582,0.006302833832921071,1210
45301,1.39184565454372,103.74663514172119,CHOA CHU KANG,104077,90974,13103,97525,0.008241718773371959,1582
45299,1.391622,103.745119,CHOA CHU KANG,51479,12798,38681,32138,0.00271594317291595,521
44549,1.38748720575146,103.746189135824,CHOA CHU KANG,1184,14385,-13201,7784,0.0006578163438290421,126
44531,1.38425405298158,103.74453624872069,CHOA CHU KANG,328812,408767,-79955,368789,0.031165908482061744,5986
44489,1.38182529982154,103.7453076883337,CHOA CHU KANG,12362,10551,1811,11456,0.0009681325841348286,185
44479,1.3804793043347,103.74828169894731,CHOA CHU KANG,14777,37076,-22299,25926,0.00219097463130932,420
44439,1.37983733026289,103.7542950355126,CHOA CHU KANG,21689,48986,-27297,35337,0.0029862867602629575,573
44421,1.37820805599688,103.7550844439833,CHOA CHU KANG,17013,32460,-15447,24736,0.0020904091830620743,401
44411,1.37852555601793,103.75322999998068,CHOA CHU KANG,15923,21882,-5959,18902,0.0015973849603104515,306
44471,1.3804703714721,103.7480231565411,CHOA CHU KANG,18741,15012,3729,16876,0.0014261701719500148,273
44481,1.38184295668756,103.74495854313909,CHOA CHU KANG,6236,13568,-7332,9902,0.0008368059399531314,160
66329,1.36602172246077,103.8722863800345,SERANGOON,12427,55387,-42960,33907,0.0034433509012912846,402
66319,1.36821833817676,103.8739176208251,SERANGOON,8272,37892,-29620,23082,0.0023440418056332154,274
66309,1.36927306510786,103.8719488184558,SERANGOON,51250,93629,-42379,72439,0.007356383517817541,859
66509,1.37528324399418,103.87015339999972,SERANGOON,33828,36332,-2504,35080,0.0035624723395552027,416
66599,1.37284849802167,103.868436813377,SERANGOON,34244,24655,9589,29449,0.0029906285042064188,349
66301,1.36937136450503,103.87207688842045,SERANGOON,100683,96997,3686,98840,0.010037479077583702,1173
66311,1.36766470740207,103.87429104816339,SERANGOON,26862,20142,6720,23502,0.0023866939830167154,279
66321,1.36514638903186,103.87249027797797,SERANGOON,23410,15249,8161,19329,0.0019629141348706533,229
66151,1.36306633208702,103.86588376967377,SERANGOON,3236,4595,-1359,3915,0.0003975792248961978,46
66161,1.36123776322522,103.86464333342467,SERANGOON,1119,8477,-7358,4798,0.0004872503502048422,56
66171,1.35976302696107,103.86361193890139,SERANGOON,12419,28186,-15767,20302,0.0020617250124757617,241
66181,1.35878665442309,103.86185764149462,SERANGOON,7495,11660,-4165,9577,0.0009725711971470975,113
66191,1.36065611099902,103.85983944399274,SERANGOON,7507,6433,1074,6970,0.0007078230389595143,82
66201,1.36208638896684,103.85966527802135,SERANGOON,6966,7234,-268,7100,0.0007210249033877406,84
66211,1.36412138937997,103.86103467229529,SERANGOON,8835,8442,393,8638,0.0008772131148539864,102
66291,1.3659363788285,103.86192411659012,SERANGOON,13638,14513,-875,14075,0.001429355706363725,167
66221,1.36834972197817,103.86262638902237,SERANGOON,2806,2975,-169,2890,0.00029348760151979864,34
66231,1.36994831751271,103.86438051938194,SERANGOON,9210,9648,-438,9429,0.0009575413822595783,111
66241,1.36890803491379,103.86562505721909,SERANGOON,1159,1198,-39,1178,0.00011962920228038851,13
66251,1.36724305880207,103.86653816215,SERANGOON,10428,4073,6355,7250,0.0007362578238818478,86
66261,1.36555110748973,103.86640982940798,SERANGOON,8653,2849,5804,5751,0.0005840301717440698,68
83063,1.32120137837522,103.91485250081533,BEDOK,684,7755,-7071,4219,0.00017181626077399743,23
62271,1.37591304823679,103.8996359517733,HOUGANG,17647,23065,-5418,20356,0.0010703939119006286,243
62251,1.377463,103.900695,HOUGANG,63515,70089,-6574,66802,0.003512696703811446,799
62261,1.374585,103.902922,HOUGANG,50517,62087,-11570,56302,0.0029605677946467476,673
64421,1.37505042808455,103.89511829229477,HOUGANG,57043,41475,15568,49259,0.0025902207558613217,589
64081,1.37602972196856,103.880089999971,HOUGANG,44973,53664,-8691,49318,0.0025933231944937707,590
64091,1.37748777797023,103.88149277798507,HOUGANG,28967,24239,4728,26603,0.0013988843210008066,318
64449,1.37973333296925,103.88860666697411,HOUGANG,51133,28574,22559,39853,0.0020956184206610213,476
64439,1.3779797322129,103.88952155230182,HOUGANG,35868,13658,22210,24763,0.0013021303026328978,296
64429,1.37481689904602,103.8952195672541,HOUGANG,62787,57176,5611,59981,0.0031540232476769308,717
64099,1.377877,103.8815677,HOUGANG,16091,16719,-628,16405,0.0008626356909377978,196
64089,1.376101,103.8802,HOUGANG,10616,19452,-8836,15034,0.0007905434305125786,179
83149,1.31745755005277,103.90875486321198,BEDOK,4864,3922,942,4393,0.00017890230708228746,24
82179,1.31383213839694,103.90453211897777,GEYLANG,9908,6749,3159,8328,0.0005562372341116892,31
82159,1.31327026591962,103.90049572645528,GEYLANG,20862,15997,4865,18429,0.0012308952914798655,68
82149,1.31101372476887,103.90136361120997,GEYLANG,45188,26796,18392,35992,0.002403949391228136,134
82141,1.31084210669638,103.90248369965865,GEYLANG,26037,30924,-4887,28480,0.0019022137881245086,106
82151,1.31310616198244,103.9009112063053,GEYLANG,19429,26483,-7054,22956,0.0015332591193885612,85
82171,1.31382614901728,103.90306992679919,GEYLANG,6810,10164,-3354,8487,0.0005668570372125248,31
82181,1.31422806856846,103.905891658307,GEYLANG,6275,14894,-8619,10584,0.000706918213957507,39
28059,1.33260638902834,103.74580722197156,JURONG EAST,69353,48859,20494,59106,0.0057643857782949705,453
28471,1.34811145616559,103.73224640616968,JURONG EAST,27270,42154,-14884,34712,0.003385330747067557,266
28481,1.34618139069958,103.73421591577221,JURONG EAST,12821,24617,-11796,18719,0.0018255936348916108,143
28051,1.33228999677029,103.74574002371804,JURONG EAST,32258,72387,-40129,52322,0.005102767784860241,401
28199,1.332679,103.743839,JURONG EAST,427,19340,-18913,9883,0.0009638518026408349,75
28541,1.35235805602121,103.7172600000334,JURONG WEST,104115,124141,-20026,114128,0.004688664239703933,613
28551,1.35309201855261,103.71993998752167,JURONG WEST,63555,74778,-11223,69166,0.0028415126069269788,371
28561,1.35318546958489,103.72232429359829,JURONG WEST,81435,83909,-2474,82672,0.003396372932363693,444
28571,1.35242067621829,103.72542293305399,JURONG WEST,93804,89591,4213,91697,0.0037671425486132375,492
28421,1.34591586108958,103.71934571086803,JURONG WEST,12781,14681,-1900,13731,0.0005641038892767305,73
28411,1.34805444396931,103.7176175000189,JURONG WEST,27986,61350,-33364,44668,0.0018350733760259996,240
28581,1.34925114010527,103.72570564902432,JURONG WEST,49046,53422,-4376,51234,0.0021048211101306544,275
28591,1.34645638903065,103.72538249998607,JURONG WEST,27788,18338,9450,23063,0.0009474858348546527,123
28601,1.34733744665393,103.72316770207861,JURONG WEST,39708,22444,17264,31076,0.0012766799550771014,167
28611,1.34927792310102,103.72106773657399,JURONG WEST,20256,8304,11952,14280,0.0005866581850463705,76
65089,1.4013394838038,103.90580511592151,PUNGGOL,28233,15896,12337,22064,0.0029986584591347844,523
75149,1.35597194444127,103.93366388890493,TAMPINES,56313,90482,-34169,73397,0.003063481606338377,796
65081,1.40092158845981,103.90531038561681,PUNGGOL,4821,17281,-12460,11051,0.0015019114680882206,262
96239,1.33007025409204,103.96193922509366,TAMPINES,619,9696,-9077,5157,0.0002152455092699567,55
96249,1.32823969887083,103.96653156328907,TAMPINES,1446,27538,-26092,14492,0.0006048745240140028,157
96219,1.31520306285456,103.98889428788505,CHANGI,58779,71136,-12357,64957,0.02073019219396901,38
96421,1.313621111,103.99655,CHANGI,1809,22328,-20519,12068,0.0038513471896303403,7
96431,1.318286944,104.0152631,CHANGI,140,12824,-12684,6482,0.0020686470403698926,3
96471,1.367866,104.009977,CHANGI,301,1955,-1654,1128,0.00035998671112885515,0
95161,1.3725170000281,104.00455640513198,CHANGI,1257,10122,-8865,5689,0.0018155712762518235,3
95171,1.37462795179536,104.0020734051487,CHANGI,8228,14732,-6504,11480,0.0036636945423397667,6
95181,1.37700618973294,104.00189840513904,CHANGI,4541,16327,-11786,10434,0.00332987707794191,6
95191,1.38009118975333,104.00092640513972,CHANGI,11973,10995,978,11484,0.003664971090960791,6
95189,1.3787447073172,104.0014724782864,CHANGI,9085,3981,5104,6533,0.0020849230352879525,3
95179,1.37635787246647,104.00221640515575,CHANGI,15464,1537,13927,8500,0.002712665819676657,5
95169,1.37262300000012,104.0046664051527,CHANGI,9399,428,8971,4913,0.0015679208437731076,2
96479,1.367858,104.010442,CHANGI,1564,178,1386,871,0.0002779684622280433,0
96439,1.317708,104.015614,CHANGI BAY,21390,146,21244,10768,1.0,0
96429,1.313721111,103.9953811,CHANGI,23934,1476,22458,12705,0.004054637557528462,7
96241,1.32746975992942,103.96702744644506,TAMPINES,22737,665,22072,11701,0.0004883823354601053,126
96271,1.32913596796858,103.96366258799002,TAMPINES,2717,487,2230,1602,6.686509712051011e-05,17
96231,1.3300314164688,103.96086883190902,TAMPINES,5770,1090,4680,3430,0.00014316309807949418,37
78099,1.37740660071471,103.95708795238238,PASIR RIS,6953,20235,-13282,13594,0.0012818255821420215,92
78251,1.37824090541171,103.9595522242097,PASIR RIS,7421,42121,-34700,24771,0.0023357438204531424,169
78261,1.37865831081472,103.9606174383779,PASIR RIS,16594,47174,-30580,31884,0.0030064533515533486,218
78271,1.37922254801698,103.96383348445823,PASIR RIS,10539,22218,-11679,16378,0.001544338633538475,112
78279,1.37923567744466,103.96426677704831,PASIR RIS,13214,5405,7809,9309,0.0008777780156068913,63
78269,1.37861875398733,103.96096176266686,PASIR RIS,30902,2177,28725,16539,0.001559519883996388,113
78259,1.37802115263457,103.95936584739643,PASIR RIS,32485,1118,31367,16801,0.0015842247760459104,114
78091,1.37681617858505,103.95624713617742,PASIR RIS,16111,9449,6662,12780,0.0012050706885225126,87
77191,1.37654807606486,103.94602815996554,PASIR RIS,42076,44579,-2503,43327,0.0040854536558384115,296
77201,1.37864001176536,103.94276350247947,PASIR RIS,96954,170651,-73697,133802,0.012616656358817624,915
77211,1.37999169580419,103.94094544562029,PASIR RIS,53455,79891,-26436,66673,0.006286829265716861,456
77221,1.37954502345926,103.93830035527515,PASIR RIS,37735,58938,-21203,48336,0.004557769702693597,330
77181,1.37591147273628,103.94109934608323,PASIR RIS,37425,44265,-6840,40845,0.003851417235735683,279
77071,1.37810945408117,103.94127900809487,PASIR RIS,82856,54594,28262,68725,0.00648031948894442,470
77209,1.37902915784394,103.94271591238348,PASIR RIS,113716,83568,30148,98642,0.009301297563164139,674
77199,1.376671,103.94637,PASIR RIS,30998,24022,6976,27510,0.0025940136651998688,188
78231,1.373443032341,103.95986036196572,PASIR RIS,27051,29631,-2580,28341,0.0026723715479981635,193
78241,1.37211000864374,103.95765320446608,PASIR RIS,37129,14994,22135,26061,0.0024573824110786543,178
77251,1.38223834152443,103.93864433688064,PASIR RIS,22708,48172,-25464,35440,0.003341760970362899,242
77261,1.38285811735056,103.93615875590504,PASIR RIS,16831,29298,-12467,23064,0.0021747848482068254,157
77271,1.38058998439068,103.9349613837619,PASIR RIS,59921,49267,10654,54594,0.005147858307448987,373
77291,1.37746279073187,103.93476034022859,PASIR RIS,77525,73090,4435,75307,0.007100959181577845,515
77279,1.38079641020594,103.9346621770568,PASIR RIS,48552,51451,-2899,50001,0.0047147683487335015,342
77269,1.38289337444624,103.9357870042478,PASIR RIS,18937,10181,8756,14559,0.0013728187914083929,99
77259,1.3827163599648,103.93855855739126,PASIR RIS,39487,15517,23970,27502,0.0025932593173510284,188
77219,1.3805766269449,103.94064766803564,PASIR RIS,50724,34125,16599,42424,0.004000306642400553,290
77179,1.37254332490473,103.95081255052568,PASIR RIS,106214,96942,9272,101578,0.00957814322368856,694
77349,1.37000783675508,103.94874237905681,PASIR RIS,19570,15710,3860,17640,0.0016633370066930456,120
77359,1.36808803474125,103.95001861343128,PASIR RIS,12838,21335,-8497,17086,0.001611098418160849,116
77369,1.36836666126193,103.95166401714877,PASIR RIS,9497,39268,-29771,24382,0.0022990636563032787,166
78171,1.36780002450028,103.95673805301494,PASIR RIS,29211,63123,-33912,46167,0.004353247142176748,315
78181,1.36476141959655,103.95905802330991,PASIR RIS,37615,79615,-42000,58615,0.005527012394972385,400
78191,1.36488943048941,103.96176906896966,PASIR RIS,16814,26084,-9270,21449,0.0020225008762221734,146
78199,1.36477,103.96189,PASIR RIS,17524,9580,7944,13552,0.0012778652559356097,92
78189,1.3646,103.95896,PASIR RIS,56826,25257,31569,41041,0.0038698987580322725,280
78179,1.36767,103.95648,PASIR RIS,35950,23877,12073,29913,0.0028206009002952987,204
77361,1.36800665136778,103.95173655442387,PASIR RIS,46950,13043,33907,29996,0.002828427259227018,205
77351,1.36789609661968,103.95008847029645,PASIR RIS,26372,15029,11343,20700,0.0019518750588744924,141
77341,1.36973888889645,103.94849805552538,PASIR RIS,11758,20748,-8990,16253,0.001532551948400344,111
77171,1.37276133738912,103.95064755544978,PASIR RIS,40919,196287,-155368,118603,0.011183489739502001,811
94099,1.31149001305165,103.95030071791084,BEDOK,5394,3411,1983,4402,0.00017926882671892314,24
82059,1.3012419783155,103.89745113021507,MARINE PARADE,38659,10718,27941,24688,0.006281243384951069,154
02149,1.29560459817725,103.85955533029184,DOWNTOWN CORE,6299,30789,-24490,18544,0.003862846453728228,6
02159,1.29360811227161,103.85840672828635,DOWNTOWN CORE,8589,28292,-19703,18440,0.003841182517620175,6
09191,1.30488653118311,103.82549755834486,ORCHARD,56535,57980,-1445,57257,0.016161647524394755,14
82051,1.30079999936599,103.89740107761654,MARINE PARADE,10840,46795,-35955,28817,0.007331764040186931,179
93199,1.30794833296674,103.92628500000932,BEDOK,8370,14284,-5914,11327,0.00046128532490805144,61
93149,1.30742050291938,103.9278209209607,BEDOK,8228,13732,-5504,10980,0.000447153956695542,60
97141,1.35231360645922,103.96793511086432,CHANGI,5588,41542,-35954,23565,0.00752046706360946,13
97151,1.34957475260085,103.96705688688903,CHANGI,4684,22333,-17649,13508,0.004310904693199092,7
97161,1.34716828634192,103.96759395445096,CHANGI,7490,27374,-19884,17432,0.005563198890423939,10
97171,1.34566460198537,103.96993803786681,CHANGI,47161,149465,-102304,98313,0.031375331144690724,58
97181,1.34784936649026,103.97214908694973,CHANGI,6918,10156,-3238,8537,0.0027244738944211316,5
97189,1.34674882374419,103.97146767080093,CHANGI,30908,8196,22712,19552,0.006239769659566822,11
97179,1.34529387211141,103.9698135852748,CHANGI,65119,681,64438,32900,0.010499612407924942,19
97169,1.34695022666824,103.96753724160826,CHANGI,16683,97,16586,8390,0.0026775607325984882,4
97159,1.35028972565622,103.96769101118204,CHANGI,23617,540,23077,12078,0.003854538561182901,7
97149,1.35180572395974,103.96795596081698,CHANGI,20257,1503,18754,10880,0.0034722122491861207,6
67231,1.39322205615326,103.90395664347085,SENGKANG,41956,126842,-84886,84399,0.006522541017338341,798
67221,1.39116246855705,103.90639445299767,SENGKANG,27631,44110,-16479,35870,0.0027721127773069143,339
67661,1.38889400053531,103.90878400579224,SENGKANG,145265,161372,-16107,153318,0.01184875346504437,1451
67671,1.39200512922492,103.90712750531712,SENGKANG,36135,28916,7219,32525,0.0025136037937526453,307
67239,1.3930503019817,103.90373341553943,SENGKANG,101760,63728,38032,82744,0.006394638964189667,783
67171,1.38731209583307,103.89897692182004,SENGKANG,73719,112554,-38835,93136,0.007197755662873064,881
67649,1.398051,103.8933425,SENGKANG,2975,22915,-19940,12945,0.00100041817402392,122
67699,1.3988295,103.889524,SENGKANG,7302,75413,-68111,41357,0.0031961602489847243,391
67701,1.3984935,103.877445,SENGKANG,12076,34179,-22103,23127,0.0017873056091657934,218
67741,1.3971275,103.875622,SENGKANG,1852,3698,-1846,2775,0.00021445812537013346,26
67691,1.39899,103.8887775,SENGKANG,44279,8766,35513,26522,0.0020496787030870917,251
67641,1.398044,103.8934405,SENGKANG,11695,3975,7720,7835,0.0006055060945135119,74
65251,1.40502618974463,103.90299618971393,PUNGGOL,125247,100214,25033,112730,0.015320828865947437,2672
65181,1.39681388886675,103.91754694442001,PUNGGOL,3223,13190,-9967,8206,0.0011152552264167893,194
65561,1.40046,103.920181,PUNGGOL,11663,25615,-13952,18639,0.0025331759889327976,441
65569,1.398633889,103.9191989,PUNGGOL,48247,42269,5978,45258,0.006150892156613582,1073
65189,1.39682694447407,103.91793305556935,PUNGGOL,13295,4075,9220,8685,0.0011803548185997826,205
65571,1.403478611,103.895535,PUNGGOL,11041,33757,-22716,22399,0.0030441874014757084,531
65551,1.40374,103.8933695,PUNGGOL,3142,22785,-19643,12963,0.0017617662076579138,307
65541,1.403562,103.8912,PUNGGOL,9913,63442,-53529,36677,0.004984671696233072,869
65531,1.4024,103.8936,PUNGGOL,40753,64290,-23537,52521,0.007137986808022934,1245
65491,1.40456320178872,103.89496045471951,PUNGGOL,5212,930,4282,3071,0.000417371289340234,72
65441,1.40817769231202,103.89579264867245,PUNGGOL,6121,6789,-668,6455,0.0008772815606288539,153
65451,1.41068999997892,103.89759188105812,PUNGGOL,63624,39913,23711,51768,0.0070356486182237814,1227
65461,1.40985888889928,103.90129988103229,PUNGGOL,31164,9394,21770,20279,0.0027560639454674717,480
65481,1.40886523796853,103.90603964310132,PUNGGOL,11113,8483,2630,9798,0.001331619633004107,232
65351,1.40589404110743,103.90472620505594,PUNGGOL,25629,41226,-15597,33427,0.004542973001880821,792
65359,1.40552300002668,103.90435300000112,PUNGGOL,28508,9845,18663,19176,0.002606158203968846,454
65489,1.40819500002156,103.90566900789092,PUNGGOL,8741,4836,3905,6788,0.0009225386883886383,160
65469,1.40982305558831,103.90097793657458,PUNGGOL,8180,26168,-17988,17174,0.00233407180824786,407
65459,1.41060953055987,103.8977216527095,PUNGGOL,13807,22844,-9037,18325,0.0024905010996938417,434
65449,1.40804081420589,103.89593121183572,PUNGGOL,13225,12821,404,13023,0.0017699206450921092,308
65499,1.40455142766372,103.89497063575236,PUNGGOL,3226,13064,-9838,8145,0.001106964881692024,193
65539,1.402291,103.8937,PUNGGOL,111336,81230,30106,96283,0.01308556165794391,2282
65549,1.403521,103.8912,PUNGGOL,58817,11164,47653,34990,0.004755396097041611,829
65559,1.404046,103.8925,PUNGGOL,30512,2022,28490,16267,0.00221080389570094,385
65579,1.403556111,103.8960314,PUNGGOL,6056,2924,3132,4490,0.0006102237346589549,106
65671,1.411223,103.898788,PUNGGOL,24528,20306,4222,22417,0.003046633732705967,531
65679,1.410983,103.898983,PUNGGOL,12735,25895,-13160,19315,0.0026250493173580656,457
65609,1.407746111,103.8981261,PUNGGOL,3174,3205,-31,3189,0.00043340834962748493,75
65619,1.4115376363476,103.9000027461105,PUNGGOL,14500,11754,2746,13127,0.0017840550033113812,311
65641,1.415276389,103.8998269,PUNGGOL,14077,19460,-5383,16768,0.002278893448276471,397
65651,1.417311944,103.9013861,PUNGGOL,26357,30071,-3714,28214,0.0038344882961398115,668
65661,1.418851944,103.9057239,PUNGGOL,64730,66524,-1794,65627,0.008919187758232347,1555
65631,1.41730626833353,103.90541762051286,PUNGGOL,2347,920,1427,1633,0.0002219366055006845,38
65621,1.416279,103.902739,PUNGGOL,7069,2693,4376,4881,0.0006633634852717949,115
65611,1.41138059190012,103.9003025582472,PUNGGOL,10464,9397,1067,9930,0.0013495593953593368,235
65601,1.407698056,103.89849,PUNGGOL,1737,2460,-723,2098,0.0002851334956156988,49
65381,1.40206799999564,103.90976700000783,PUNGGOL,9605,20709,-11104,15157,0.0020599468031683252,359
65391,1.40587968028504,103.91251694444946,PUNGGOL,28316,107140,-78824,67728,0.009204728975719756,1605
65319,1.40257805553795,103.91244500001986,PUNGGOL,65387,46101,19286,55744,0.007576016005529796,1321
65371,1.40288670334271,103.91626762051331,PUNGGOL,22209,75075,-52866,48642,0.006610802427902201,1153
65419,1.39946209125417,103.91395382625832,PUNGGOL,10745,12865,-2120,11805,0.0016043855651779427,279
65429,1.39678724110144,103.912022758935,PUNGGOL,10251,16717,-6466,13484,0.0018325739060448436,319
65411,1.39944781445392,103.91384912994876,PUNGGOL,15826,10122,5704,12974,0.0017632611878541829,307
65379,1.40280775893278,103.91633762054916,PUNGGOL,61037,29318,31719,45177,0.006139883666077418,1071
65311,1.40201500002599,103.91285694443438,PUNGGOL,38852,65513,-26661,52182,0.0070919142365197295,1237
65399,1.40580472725369,103.91259546667418,PUNGGOL,101643,23474,78169,62558,0.008502088283473251,1483
65389,1.40225699999819,103.91007199999862,PUNGGOL,28009,10643,17366,19326,0.0026265442975543347,458
55281,1.39813695687252,103.82881324249821,YISHUN,1125,1720,-595,1422,7.131453909368248e-05,15
59011,1.40205059877403,103.82737908252,YISHUN,3825,24357,-20532,14091,0.000706675928529592,156
59021,1.40922833847299,103.82908330455543,YISHUN,3034,12763,-9729,7898,0.0003960915821110438,87
59029,1.40885843406387,103.82924769115782,YISHUN,6882,4151,2731,5516,0.0002766322064984195,61
59019,1.40217670308957,103.82763036053306,YISHUN,24640,3872,20768,14256,0.0007149508223062851,158
55289,1.39844339285315,103.82903916367646,YISHUN,1758,1597,161,1677,8.410301129402639e-05,18
98301,1.36001388887382,103.96487611110979,PASIR RIS,10278,113271,-102993,61774,0.005824885501783231,422
98311,1.35930611110109,103.96849111110153,PASIR RIS,26699,71047,-44348,48873,0.0046084053020470075,334
97301,1.35182434688859,103.96979848322833,CHANGI,26357,26120,237,26238,0.008373520679608955,15
97311,1.35255805555221,103.97290111112585,CHANGI,27635,30717,-3082,29176,0.00931114564175131,17
97331,1.3556366037228,103.97509801681349,CHANGI,19851,14798,5053,17324,0.005528732077656282,10
97321,1.36060285135304,103.97464120182451,CHANGI,22147,18462,3685,20304,0.0064797608003193926,11
98319,1.3592369444173,103.96845690524152,PASIR RIS,76886,27993,48893,52439,0.004944655855667609,358
98309,1.35996000001358,103.96473694441013,PASIR RIS,83443,4248,79195,43845,0.004134297679050826,299
83249,1.31786650545216,103.92174594601859,BEDOK,10389,15563,-5174,12976,0.000528439867220524,70
83239,1.3169597007985,103.92246139079549,BEDOK,9877,10197,-320,10037,0.0004087508436569358,54
93119,1.31431984916508,103.92298221289045,BEDOK,3198,10151,-6953,6674,0.0002717946727673996,36
93111,1.31451280258696,103.92278173877762,BEDOK,7087,4509,2578,5798,0.00023612009480152574,31
83231,1.31726812920156,103.92214229972099,BEDOK,13564,14135,-571,13849,0.0005639922719741859,75
03331,1.27663307202767,103.86076808024792,MARINA SOUTH,379,495,-116,437,0.022310716291417777,0
03341,1.27959780011944,103.8643376844082,MARINA SOUTH,728,1481,-753,1104,0.05636391484147649,0
03371,1.28066479303461,103.86626955523418,MARINA SOUTH,1966,5882,-3916,3924,0.2003369581865523,0
03369,1.27960772061959,103.8698744774074,MARINA SOUTH,9218,12135,-2917,10676,0.5450553938836984,0
03361,1.279917,103.868895,MARINA SOUTH,4554,971,3583,2762,0.14101189564507072,0
03349,1.27965600609923,103.8647780795552,MARINA SOUTH,1248,120,1128,684,0.03492112115178435,0
03419,1.27127698470973,103.86297693157816,STRAITS VIEW,9092,11013,-1921,10052,0.3626131813426644,0
03421,1.26694090294712,103.85964778134667,STRAITS VIEW,15264,10217,5047,12740,0.45957938025323763,0
03411,1.27159299884076,103.86300900488229,STRAITS VIEW,780,8657,-7877,4718,0.17019588037949568,0
03339,1.27498516412784,103.85950016250487,STRAITS VIEW,193,229,-36,211,0.007611558024602287,0
93159,1.3077547570517,103.93132371442206,BEDOK,760,1758,-998,1259,5.1272024724926e-05,6
93169,1.30594307438981,103.92711976208209,BEDOK,190,190,0,190,7.737636773420126e-06,1
93179,1.30480179616528,103.92345623316808,BEDOK,398,364,34,381,1.5515997950910886e-05,2
93189,1.30365171489985,103.91955288064976,BEDOK,548,178,370,363,1.4782958677639504e-05,1
92199,1.302895,103.91685,MARINE PARADE,484,184,300,334,8.49779362675655e-05,2
92289,1.30179664907354,103.91282770401249,MARINE PARADE,1760,646,1114,1203,0.00030607322553856674,7
91111,1.29535544538917,103.89246238709205,MARINE PARADE,30,112,-82,71,1.8064172080829792e-05,0
91101,1.29607137626294,103.89668750894906,MARINE PARADE,52,196,-144,124,3.15486949017309e-05,0
92261,1.29798119441776,103.90051820688359,MARINE PARADE,296,312,-16,304,7.73451875010177e-05,1
92251,1.30003666698438,103.90625361097798,MARINE PARADE,250,222,28,236,6.0044290296842686e-05,1
92191,1.30244833118536,103.91471180502236,MARINE PARADE,750,522,228,636,0.00016181427385081334,3
93181,1.30333972198999,103.91793277803113,MARINE PARADE,626,198,428,412,0.00010482308306058977,2
93171,1.30510333301496,103.9241758329893,BEDOK,458,158,300,308,1.254311645375473e-05,1
93161,1.30651832392551,103.92790223080911,BEDOK,236,128,108,182,7.411841540855068e-06,0
93151,1.30788664966156,103.9337756712752,BEDOK,2010,796,1214,1403,5.713633891109704e-05,7
77081,1.38026998386867,103.94265250854711,PASIR RIS,1156,5119,-3963,3137,0.0002957986502265354,21
77091,1.38042637835149,103.94547139015036,PASIR RIS,285,8939,-8654,4612,0.00043488153485648107,31
77101,1.380642,103.948183,PASIR RIS,2013,6882,-4869,4447,0.00041932311047414815,30
77111,1.38219835929252,103.94638094436415,PASIR RIS,1424,6985,-5561,4204,0.00039640979456562154,28
77129,1.38396304779096,103.94374627572016,PASIR RIS,15665,14578,1087,15121,0.0014258117277894298,103
77119,1.38222775917912,103.94657905489993,PASIR RIS,6328,250,6078,3289,0.00031013125935450267,22
77109,1.3805263866174,103.94826215873827,PASIR RIS,5511,164,5347,2837,0.000267510605895021,19
77099,1.38042138903141,103.94637916697367,PASIR RIS,3992,235,3757,2113,0.00019924212557496628,14
77089,1.38005668836989,103.9426864870342,PASIR RIS,1688,736,952,1212,0.0001142836990993181,8
77079,1.37728664750339,103.94145255170352,PASIR RIS,32346,13578,18768,22962,0.002165166913134111,157
77189,1.3755564005294,103.94124910119332,PASIR RIS,11621,14889,-3268,13255,0.0012498600920474105,90
31061,1.37594722202959,103.695570278013,WESTERN WATER CATCHMENT,266,4265,-3999,2265,0.0015920197986815405,0
31071,1.37853314214565,103.69626045229732,WESTERN WATER CATCHMENT,15,576,-561,295,0.00020734915700267305,0
31079,1.37768611102662,103.69632194402648,WESTERN WATER CATCHMENT,859,34,825,446,0.0003134838102481091,0
31069,1.37493138896603,103.69550611102841,WESTERN WATER CATCHMENT,6567,618,5949,3592,0.0025247395659444122,0
42211,1.33974260070464,103.76559520495253,BUKIT TIMAH,16659,14779,1880,15719,0.002606591846751834,202
42221,1.33957381292395,103.7679072102881,BUKIT TIMAH,21670,16299,5371,18984,0.0031480081187567157,245
42229,1.33943222197209,103.76827388898352,BUKIT TIMAH,18105,25048,-6943,21576,0.0035778246507740677,278
42219,1.3395991670039,103.76535388898161,BUKIT TIMAH,10681,22858,-12177,16769,0.0027807073400459,216
53009,1.35045541249544,103.84988083722291,BISHAN,1310608,735173,575435,1022890,0.13422048222745456,11720
53261,1.35285975794309,103.85179055539538,BISHAN,23811,19715,4096,21763,0.002855673977374003,249
53299,1.35174011670427,103.83794546128104,BISHAN,13546,24656,-11110,19101,0.0025063745183026617,218
53129,1.34968057726521,103.83978033272378,BISHAN,23245,62509,-39264,42877,0.005626188169271935,491
53319,1.34722500001495,103.8412483330228,BISHAN,9461,13877,-4416,11669,0.0015311703185212167,133
53309,1.34849137843448,103.8452725001234,BISHAN,3001,4546,-1545,3773,0.0004950814647168182,43
53419,1.34639996494893,103.84980877522956,BISHAN,13147,14941,-1794,14044,0.0018428105196085327,160
53409,1.34534609724691,103.85126805621526,BISHAN,42001,10229,31772,26115,0.0034267300426927393,299
53281,1.34665638902153,103.85432083296934,BISHAN,182193,69367,112826,125780,0.016504465049584253,1441
53271,1.3493461110909,103.85391500001569,BISHAN,94750,41953,52797,68351,0.008968808161902793,783
53279,1.34970265350038,103.85391302825673,BISHAN,51634,97629,-45995,74631,0.009792850462041043,855
53289,1.347206111,103.8545811,BISHAN,59938,163567,-103629,111752,0.014663754000804097,1280
53401,1.3454166669782,103.85048888897714,BISHAN,21386,47952,-26566,34669,0.004549159634314171,397
53221,1.34816840593896,103.8484543562104,BISHAN,163717,37671,126046,100694,0.013212757224541554,1153
53301,1.348611,103.845924,BISHAN,3517,2097,1420,2807,0.000368325913453514,32
53311,1.34684500003106,103.84162388899554,BISHAN,17740,10689,7051,14214,0.0018651173971600459,162
53121,1.35016694219359,103.83947418569129,BISHAN,216067,83346,132721,149706,0.019643961239569567,1715
53291,1.35231394964571,103.8371139764859,BISHAN,24965,21417,3548,23191,0.0030430517488067134,265
53269,1.35335792415265,103.8511190167485,BISHAN,11715,27616,-15901,19665,0.002580380865002976,225
83331,1.32349513640884,103.91271655859842,BEDOK,1966,836,1130,1401,5.705489010295577e-05,7
83341,1.32539968158209,103.91109803643086,BEDOK,10606,14278,-3672,12442,0.0005066930354468064,68
83351,1.32765583299859,103.91213111102074,BEDOK,11473,12329,-856,11901,0.0004846611328445943,65
83361,1.32850781433023,103.914495706562,BEDOK,47071,56670,-9599,51870,0.0021123748391436944,283
83371,1.32624566683557,103.91537946119738,BEDOK,10036,7526,2510,8781,0.0003576009921442217,47
83381,1.32466780744529,103.91452207182714,BEDOK,2047,1956,91,2001,8.148953254533512e-05,10
83251,1.31923829366992,103.92199914721091,BEDOK,2970,6178,-3208,4574,0.00018627342421907188,24
83261,1.3190690667828,103.9242469847813,BEDOK,7664,16122,-8458,11893,0.0004843353376120293,65
83271,1.31928964158986,103.92588543589487,BEDOK,2634,10749,-8115,6691,0.00027248698763660033,36
83281,1.31965172299504,103.9270176945798,BEDOK,4647,4672,-25,4659,0.00018973499856507562,25
83279,1.3188308339316,103.92510530820441,BEDOK,16387,1698,14689,9042,0.0003682300616066567,49
83269,1.31895097253228,103.92346501346623,BEDOK,4424,341,4083,2382,9.700553049624601e-05,13
83229,1.31661259109687,103.92083645128875,BEDOK,5888,5012,876,5450,0.00022194800218494572,29
83219,1.31587375170111,103.9191305648774,BEDOK,12618,4108,8510,8363,0.0003405781912426975,45
54601,1.35942138902131,103.85514583300495,ANG MO KIO,24936,53248,-28312,39092,0.002319246141773383,376
54581,1.37105833303092,103.85665833302312,ANG MO KIO,39249,106716,-67467,72982,0.004329868564384147,702
54571,1.37425472964633,103.85491933752174,ANG MO KIO,80510,181530,-101020,131020,0.007773141038963181,1261
54251,1.37689002832989,103.84617199453344,ANG MO KIO,1592,10731,-9139,6161,0.00036551917219548283,59
55181,1.38143251435794,103.84389230276943,ANG MO KIO,94560,59599,34961,77079,0.00457293495758085,742
55189,1.382955556,103.844225,ANG MO KIO,74549,237830,-163281,156189,0.009266364873566022,1503
54259,1.3772094440158,103.84628222196814,ANG MO KIO,9359,758,8601,5058,0.00030008050202317025,48
54579,1.37487817367914,103.85483080978989,ANG MO KIO,124659,55969,68690,90314,0.005358139671751799,869
75209,1.35145000000178,103.93361000002287,TAMPINES,15698,20179,-4481,17938,0.0007487054382944509,194
84299,1.33800081413595,103.94750053856653,TAMPINES,0,20,-20,10,4.1738512559619293e-07,0
28069,1.33644240098532,103.74255737341373,JURONG EAST,36942,39180,-2238,38061,0.00371194611558361,291
28061,1.33596390763107,103.74254813709638,JURONG EAST,132345,80461,51884,106403,0.010377084221025273,815
78129,1.375132,103.962121,PASIR RIS,23895,21714,2181,22804,0.0021502685431195132,155
78139,1.37321804486777,103.9639885558376,PASIR RIS,13754,60354,-46600,37054,0.0034939506488664463,253
78149,1.36970105283111,103.96411887211589,PASIR RIS,23764,24692,-928,24228,0.0022845424602131012,165
97121,1.36480128195808,103.96765175009287,PASIR RIS,1651,5052,-3401,3351,0.00031597745518301563,22
98291,1.356979,103.9651894,PASIR RIS,78406,26059,52347,52232,0.004925137105078864,357
96261,1.34404967237603,103.95585935578698,TAMPINES,36112,21092,15020,28602,0.001193804936230231,310
96251,1.34026697859529,103.95138028105873,TAMPINES,62574,73832,-11258,68203,0.0028466917721037144,739
96259,1.34043019344412,103.95124680626643,TAMPINES,94484,77561,16923,86022,0.0035904303274035708,933
96269,1.34431781695634,103.95588755609721,TAMPINES,21617,30894,-9277,26255,0.0010958446472528044,284
98299,1.355878,103.9655714,PASIR RIS,24638,80456,-55818,52547,0.004954839551626954,359
97129,1.36461847541947,103.96762195035996,PASIR RIS,3191,3304,-113,3247,0.0003061709331480906,22
78141,1.370066,103.963665,PASIR RIS,51348,21618,29730,36483,0.0034401090711554637,249
78131,1.37308472383764,103.9637271722912,PASIR RIS,57744,13179,44565,35461,0.003343741133466105,242
78121,1.37485968829133,103.96200053620825,PASIR RIS,38950,24969,13981,31959,0.003013525362636227,218
66461,1.37889000002038,103.87128027800178,SERANGOON,43654,69934,-26280,56794,0.0057675899102821605,674
66471,1.37895833299995,103.8743605559661,SERANGOON,26635,43963,-17328,35299,0.0035847124034765992,419
65801,1.3904399999914,103.88569800003212,SENGKANG,26934,26636,298,26785,0.0020700039236176667,253
67531,1.38786807176296,103.90676693747147,SENGKANG,21882,41833,-19951,31857,0.002461979279249132,301
67521,1.38710967446608,103.90839913039454,SENGKANG,35999,48414,-12415,42206,0.003261772843016884,399
65521,1.39031766666667,103.912942666667,PUNGGOL,37457,80979,-43522,59218,0.008048157932969709,1404
65321,1.39942700000453,103.91659300001999,PUNGGOL,19696,45279,-25583,32487,0.004415220148745094,770
65301,1.404378889,103.9096331,PUNGGOL,17698,21907,-4209,19802,0.002691236167865618,469
65309,1.40494388890828,103.90913500001737,PUNGGOL,19475,13955,5520,16715,0.0022716903618762653,396
65329,1.39988799999567,103.91612399998853,PUNGGOL,45447,21180,24267,33313,0.00452747957075585,789
65529,1.39161433333333,103.914103333333,PUNGGOL,78591,24165,54426,51378,0.0069826447749015115,1218
67529,1.38731666838873,103.9092635072425,SENGKANG,28922,21881,7041,25401,0.001963045348658292,240
67539,1.38772020397705,103.90661294770753,SENGKANG,39283,24469,14814,31876,0.0024634476411886036,301
65809,1.39121000003879,103.88630888889303,SENGKANG,35572,42327,-6755,38949,0.003010064693708587,368
66479,1.37863834733323,103.87430288480033,SERANGOON,60260,47535,12725,53897,0.005473391439139303,639
53229,1.34822303496432,103.84927239325486,BISHAN,27775,127584,-99809,77679,0.010192799654846995,890
41161,1.335063889,103.8187389,NOVENA,6054,5329,725,5691,0.0009830407760684588,48
64211,1.36219637653141,103.89765089844938,HOUGANG,3278,6900,-3622,5089,0.00026759847797515714,60
64221,1.36263972024077,103.90086280526522,HOUGANG,2388,5928,-3540,4158,0.00021864304802922055,49
64131,1.3630249842487,103.9035055135566,HOUGANG,6768,5610,1158,6189,0.00032544055417336364,74
64229,1.36242315234874,103.90226237890849,HOUGANG,10462,9388,1074,9925,0.0005218932784247268,118
64219,1.36194642289744,103.89836719781479,HOUGANG,5154,5692,-538,5423,0.000285161435657158,64
53251,1.34678829540395,103.85199823380812,BISHAN,41590,38556,3034,40073,0.005258255906598742,459
53159,1.358612,103.841265,BISHAN,28461,14946,13515,21703,0.0028478009617675863,248
53149,1.35548111090619,103.84161232917471,BISHAN,42710,53757,-11047,48233,0.006328986029071373,552
53139,1.35256345999653,103.8404366731736,BISHAN,22065,33147,-11082,27606,0.0036223744805121867,316
53119,1.347063,103.839451,BISHAN,8054,3756,4298,5905,0.0007748359525981476,67
51089,1.34154969745419,103.83962581957273,TOA PAYOH,24736,26602,-1866,25669,0.0019371995365331804,236
51081,1.3405549685403,103.83888813472058,TOA PAYOH,24427,27957,-3530,26192,0.0019766695337129245,240
53111,1.34549638897792,103.83890138902032,BISHAN,1234,2484,-1250,1859,0.0002439322668721349,21
53131,1.35315805208995,103.84031279218438,BISHAN,19343,26189,-6846,22766,0.00298728455492793,260
53141,1.35566500759395,103.84132706520519,BISHAN,39150,52701,-13551,45925,0.0060261373620778885,526
53151,1.357995,103.841113,BISHAN,19357,28957,-9600,24157,0.003169807300070017,276
53259,1.3471159591462,103.85199575975044,BISHAN,19770,32490,-12720,26130,0.0034286982965943433,299
07569,1.29949531348401,103.85301395376233,ROCHOR,10296,15340,-5044,12818,0.003306623410728649,21
01639,1.29738750001468,103.85557583297624,DOWNTOWN CORE,2403,14474,-12071,8438,0.0017576951238437656,2
01631,1.29693614589482,103.85580555528077,DOWNTOWN CORE,18229,2370,15859,10299,0.0021453545959311377,3
07561,1.29945446471936,103.85267983857253,ROCHOR,20078,1440,18638,10759,0.0027754689714487076,18
07571,1.30063444632288,103.85114009314601,ROCHOR,15197,1535,13662,8366,0.002158153491508494,14
52349,1.33619305600558,103.85544250002881,TOA PAYOH,37725,29547,8178,33636,0.002538456644623088,309
70091,1.33071735944004,103.89091372491255,GEYLANG,13296,8175,5121,10735,0.0007170036873425773,40
70081,1.33227580149459,103.89497442435284,GEYLANG,43538,68808,-25270,56173,0.003751862890460605,209
75401,1.3517582770335,103.92671414169045,TAMPINES,4538,3252,1286,3895,0.00016257150641971714,42
75411,1.35607656836954,103.92905500001906,PAYA LEBAR,395,2274,-1879,1334,0.0018781563656688786,0
75409,1.35220181029011,103.92724068972525,PAYA LEBAR,11496,7764,3732,9630,0.013558205248419265,0
70089,1.33187702164512,103.89443953236938,GEYLANG,68051,52105,15946,60078,0.004012682582968548,224
70099,1.33063155191578,103.89132142065273,GEYLANG,9807,14159,-4352,11983,0.0008003591230019659,44
98121,1.37205479195352,103.97023200986916,PASIR RIS,5467,20808,-15341,13137,0.0012387334612770147,89
98131,1.3741140347487,103.97225879434563,PASIR RIS,806,18652,-17846,9729,0.0009173812776710114,66
98141,1.37600551742745,103.974121669607,PASIR RIS,2372,25282,-22910,13827,0.0013037959632394979,94
98151,1.37772871219159,103.97590756415319,PASIR RIS,2394,8824,-6430,5609,0.0005288921355182138,38
98161,1.37986849530321,103.9759182930092,PASIR RIS,11366,17681,-6315,14523,0.001369424226088611,99
98171,1.38209408212027,103.97466838363384,PASIR RIS,9859,15618,-5759,12738,0.0012011103623161005,87
98181,1.38434111832012,103.97345066073454,PASIR RIS,23195,24066,-871,23630,0.0022281549585122826,161
98199,1.38495784630142,103.97185206410448,PASIR RIS,9310,10980,-1670,10145,0.0009566073658107113,69
98209,1.38155828919575,103.97266651518974,PASIR RIS,32909,34807,-1898,33858,0.003192588683254713,231
98219,1.38022304984,103.97340977330899,PASIR RIS,3766,3354,412,3560,0.00033568479273397064,24
98229,1.37796803000431,103.97468689087003,PASIR RIS,3468,244,3224,1856,0.00017500870093096896,12
98149,1.37583493620324,103.974255326806,PASIR RIS,20726,1471,19255,11098,0.001046469053303822,75
98139,1.37394091672222,103.97236010514752,PASIR RIS,21197,501,20696,10849,0.0010229899765086651,74
98129,1.37213166662042,103.97053295605356,PASIR RIS,24369,2852,21517,13610,0.0012833342778397023,93
11459,1.30097055597804,103.7968519439962,QUEENSTOWN,11343,7841,3502,9592,0.0008329940683041242,79
11449,1.29840527801842,103.79760333302292,QUEENSTOWN,2140,4288,-2148,3214,0.0002791120658391842,26
11441,1.29780416697573,103.79754055603178,QUEENSTOWN,2151,2974,-823,2562,0.00022249070089607652,21
11451,1.30034972200468,103.79707277801477,QUEENSTOWN,7147,9037,-1890,8092,0.000702730191901269,67
65201,1.40083471013366,103.903580214986,PUNGGOL,46321,38690,7631,42505,0.005776739385674583,1007
67519,1.38565333297959,103.9062883329725,SENGKANG,7736,3913,3823,5824,0.0004500915755515882,55
67509,1.38409640027402,103.9043380418217,SENGKANG,3651,6001,-2350,4826,0.00037296393262568076,45
67501,1.38354973187936,103.903650012666,SENGKANG,11341,13763,-2422,12552,0.0009700462665390686,118
67511,1.38603041619808,103.90624523161839,SENGKANG,6758,15081,-8323,10919,0.0008438444219518873,103
65209,1.40040560689368,103.90387509832152,PUNGGOL,38861,42130,-3269,40495,0.005503565731629038,960
10481,1.28784195484767,103.81797160113335,BUKIT MERAH,44012,25252,18760,34632,0.0020182073398014415,305
10459,1.28754723360397,103.81639920301684,BUKIT MERAH,7426,20635,-13209,14030,0.0008176094068322425,123
10419,1.28842024220748,103.81257549749508,BUKIT MERAH,531,13023,-12492,6777,0.0003949350641555316,59
10409,1.28788221830638,103.81099317775703,BUKIT MERAH,493,38528,-38035,19510,0.0011369607645970814,171
10599,1.28883435010664,103.80924997344987,BUKIT MERAH,79164,95604,-16440,87384,0.005092372088854504,770
10401,1.28816729863,103.81167850401884,BUKIT MERAH,28668,164,28504,14416,0.0008401038637842914,127
10411,1.28912979528004,103.81280840030111,BUKIT MERAH,11130,462,10668,5796,0.0003377665090520084,51
10451,1.28762380319765,103.8172559639682,BUKIT MERAH,17561,5241,12320,11401,0.0006644023412184175,100
10489,1.28811638897142,103.81778388900163,BUKIT MERAH,30186,21133,9053,25659,0.0014952986293591242,226
11541,1.29235984013148,103.80578500139798,QUEENSTOWN,2017,6062,-4045,4039,0.0003507571978607545,33
11551,1.29126703051517,103.8040959835246,QUEENSTOWN,6530,33488,-26958,20009,0.0017376332686298186,166
11561,1.29107396045212,103.80247592924283,QUEENSTOWN,3194,12727,-9533,7960,0.0006912669707778178,66
11579,1.29256489056942,103.80303321252237,QUEENSTOWN,15717,28349,-12632,22033,0.0019134026591894045,183
11589,1.292991881006,103.80400524995773,QUEENSTOWN,17067,22957,-5890,20012,0.0017378937963826242,166
11599,1.29420805600708,103.80314888900556,QUEENSTOWN,17375,15781,1594,16578,0.0014396763620043546,138
11609,1.29188972202709,103.80212194401808,QUEENSTOWN,9582,1395,8187,5488,0.00047659210246591257,45
03241,1.27456,103.84537,DOWNTOWN CORE,3385,16125,-12740,9755,0.0020320355455197836,3
67439,1.39549374900087,103.89737027918684,SENGKANG,11693,27834,-16141,19763,0.0015273282636720533,187
67229,1.39105777803334,103.90614361099206,SENGKANG,28247,14871,13376,21559,0.0016661271080557504,204
67431,1.39521359607395,103.89739500115256,SENGKANG,3629,10190,-6561,6909,0.000533942770516127,65
58121,1.45329115486737,103.81929476185202,SEMBAWANG,68220,144240,-76020,106230,0.014008790077298243,1437
58401,1.45575658287341,103.81800207598671,SEMBAWANG,11977,87335,-75358,49656,0.006548248894646725,672
58411,1.45461200191848,103.81658372927154,SEMBAWANG,50270,118085,-67815,84177,0.011100611148797273,1139
58341,1.45267992935187,103.81687772159036,SEMBAWANG,167767,51327,116440,109547,0.014446210360517657,1482
58311,1.4501979542693,103.81810459422103,SEMBAWANG,27272,20438,6834,23855,0.003145812739282214,322
58291,1.44579319988216,103.8199449173096,SEMBAWANG,53648,44107,9541,48877,0.006445520404858385,661
58391,1.44426472199698,103.82241222202445,SEMBAWANG,16478,10594,5884,13536,0.0017850228982990589,183
58399,1.44399912458783,103.822564665947,SEMBAWANG,1380,8079,-6699,4729,0.0006236239129769688,64
58299,1.44582915331137,103.81968463382916,SEMBAWANG,39017,44630,-5613,41823,0.005515293489624818,566
58319,1.44976933938251,103.81802192152004,SEMBAWANG,29265,21470,7795,25367,0.0033452035949432793,343
58349,1.45273139537549,103.81642343207659,SEMBAWANG,69505,153751,-84246,111628,0.014720636531569692,1510
58419,1.4546446175566,103.81583789207467,SEMBAWANG,134558,63131,71427,98844,0.013034781572065024,1337
58409,1.4561083849161,103.81810058815044,SEMBAWANG,82641,18117,64524,50379,0.006643592537929099,681
58129,1.45284216119403,103.8198821920911,SEMBAWANG,129376,78774,50602,104075,0.013724605359077612,1408
43351,1.34701122644751,103.7411014207074,BUKIT BATOK,104559,51728,52831,78143,0.006287561790986747,487
43361,1.3469143511774,103.74343203545553,BUKIT BATOK,94702,37823,56879,66262,0.005331589769964857,413
43141,1.34421891680123,103.75586020801809,BUKIT BATOK,60018,67708,-7690,63863,0.005138560826405265,398
43149,1.34399483001027,103.7561003299722,BUKIT BATOK,58952,81327,-22375,70139,0.005643541922603681,437
43369,1.34687447962614,103.7435830555251,BUKIT BATOK,42749,67518,-24769,55133,0.004436125362764065,343
43359,1.34689882191148,103.74106453897556,BUKIT BATOK,51462,95416,-43954,73439,0.0059090673555952005,457
64251,1.37719,103.88271,HOUGANG,1925,0,1925,962,5.0585524820613316e-05,11
64259,1.37706,103.88323,HOUGANG,0,100,-100,50,2.629185281736659e-06,0
59591,1.42653688735925,103.84947950182573,YISHUN,104954,142466,-37512,123710,0.0062041642976648805,1374
59601,1.429842,103.849376,YISHUN,168797,98477,70320,133637,0.006702011997793562,1485
59801,1.431669,103.847891,YISHUN,4648,3888,760,4268,0.00021404391902379524,47
59649,1.431392,103.845705,YISHUN,31226,24132,7094,27679,0.0013881259687581135,307
59399,1.43026750784845,103.84552062872451,YISHUN,115119,184558,-69439,149838,0.007514506264922078,1665
59409,1.42663883088373,103.84640616622914,YISHUN,194605,136990,57615,165797,0.008314864021178111,1842
59419,1.42525968028764,103.84598027430432,YISHUN,329785,189129,140656,259457,0.013011994634057366,2883
59411,1.42521425593657,103.84572707357924,YISHUN,122956,203162,-80206,163059,0.00817755093535638,1812
59401,1.42705456686774,103.84615134332738,YISHUN,75131,77619,-2488,76375,0.003830272801181434,848
59391,1.43021107363512,103.84523111093658,YISHUN,172490,90703,81787,131596,0.006599654069319437,1462
59641,1.43152,103.8457231,YISHUN,94358,120909,-26551,107633,0.005397888738586727,1196
59609,1.4289961111075,103.8495613888577,YISHUN,5019,48292,-43273,26655,0.0013367714764712423,296
59599,1.42640861109823,103.84968027780072,YISHUN,0,715,-715,357,1.7903861080481465e-05,3
46141,1.44364959550382,103.77329520911692,WOODLANDS,121333,32443,88890,76888,0.0030558417238686444,779
46151,1.44582725741537,103.77347243148317,WOODLANDS,177667,33526,144141,105596,0.0041968143621063545,1070
46161,1.44536006142756,103.77556464561282,WOODLANDS,28773,4650,24123,16711,0.0006641630819837805,169
46171,1.44412876526641,103.77800011395242,WOODLANDS,116792,59351,57441,88071,0.0035002996106393114,893
46241,1.44211845227565,103.77894354468205,WOODLANDS,67395,12701,54694,40048,0.001591670343323945,406
46641,1.43537882843176,103.79002659369449,WOODLANDS,44380,21990,22390,33185,0.001318906820395653,336
47581,1.43464494959345,103.79352674536875,WOODLANDS,18016,18761,-745,18388,0.0007308138801698136,186
46651,1.43298096854241,103.79455264522785,WOODLANDS,16800,148878,-132078,82839,0.003292358658874657,839
46961,1.43048944407628,103.79285722250489,WOODLANDS,3745,65,3680,1905,7.571244516660294e-05,19
46981,1.42742,103.793617,WOODLANDS,73495,59370,14125,66432,0.00264027777286497,673
46991,1.42764093083406,103.79587149975599,WOODLANDS,2360,225,2135,1292,5.1349332889895546e-05,13
46999,1.42742826147903,103.79600329149085,WOODLANDS,9988,5691,4297,7839,0.0003115537310556433,79
46989,1.42802334589801,103.79221259917931,WOODLANDS,35996,71721,-35725,53858,0.0021405358906996857,546
46969,1.43059181782407,103.79269972105995,WOODLANDS,93502,50244,43258,71873,0.002856525234361813,728
46659,1.43269272771322,103.79414300304941,WOODLANDS,114699,9782,104917,62240,0.002473670649432739,631
47589,1.43479106906247,103.79254444311259,WOODLANDS,20440,20218,222,20329,0.0008079571117017698,206
46649,1.43513571565336,103.79042134084122,WOODLANDS,34559,69491,-34932,52025,0.0020676850182637894,527
46249,1.44211238924063,103.77874767257565,WOODLANDS,15914,103008,-87094,59461,0.0023632218908406183,602
46179,1.44401436320878,103.77787477069215,WOODLANDS,85160,154001,-68841,119580,0.004752595376914636,1212
46169,1.44535191044578,103.77526673254576,WOODLANDS,6426,31800,-25374,19113,0.0007596283278053974,193
46159,1.4456557748871,103.77343912801257,WOODLANDS,26520,192855,-166335,109687,0.004359407334902456,1112
46149,1.4436158329924,103.77379694403167,WOODLANDS,17335,142344,-125009,79839,0.0031731264617618966,809
55179,1.385991667,103.8431694,ANG MO KIO,49238,24744,24494,36991,0.00219459823059294,356
55171,1.385783333,103.8429056,ANG MO KIO,26785,53838,-27053,40311,0.002391566847974697,388
59219,1.44045526236363,103.83757625759554,YISHUN,37614,73836,-36222,55725,0.0027946573073104474,619
59201,1.43871588444799,103.8403521964609,YISHUN,146434,90729,55705,118581,0.005946940478388159,1317
59191,1.43649083301477,103.84212083297022,YISHUN,158020,92436,65584,125228,0.006280293320410457,1391
59181,1.43416611096992,103.84218833299445,YISHUN,274423,110131,164292,192277,0.00964285909515892,2136
59241,1.43427221606754,103.83922930159359,YISHUN,124652,157607,-32955,141129,0.007077742326126803,1568
59231,1.43537970016985,103.83680745007868,YISHUN,157412,121396,36016,139404,0.00699123207300683,1549
59101,1.43420210733558,103.83302746443204,YISHUN,23913,36954,-13041,30433,0.0015262414685218277,338
59121,1.43453851053761,103.82999668990018,YISHUN,58088,85472,-27384,71780,0.0035998295472183745,797
59131,1.43192545956112,103.82969184791156,YISHUN,65113,65980,-867,65546,0.0032871890150734965,728
59301,1.42857438462559,103.8305483297094,YISHUN,14354,17339,-2985,15846,0.0007946907077907824,176
59311,1.4260484365847,103.83218609995292,YISHUN,95796,43210,52586,69503,0.003485636013100009,772
59081,1.42371474872973,103.83164666791833,YISHUN,42696,26434,16262,34565,0.001733464869038773,384
59321,1.42004673882783,103.831802328761,YISHUN,73775,61081,12694,67428,0.0033815729549991715,749
59561,1.41870141531997,103.83293375107691,YISHUN,589631,229321,360310,409476,0.02053557820669812,4550
59569,1.41849332350079,103.83293900021363,YISHUN,199349,745734,-546385,472541,0.023698342909892978,5251
59329,1.41968029160119,103.83179596945222,YISHUN,27930,25563,2367,26746,0.001341335205766267,297
59089,1.42397861098025,103.83155749997911,YISHUN,18662,30605,-11943,24633,0.0012353664145532213,273
59319,1.42617166698404,103.83201083297399,YISHUN,49057,106964,-57907,78010,0.003912269475877757,866
59309,1.42826195477761,103.83063072371398,YISHUN,44222,57916,-13694,51069,0.00256115485019358,567
59139,1.43140749331253,103.82955664267413,YISHUN,165547,97300,68247,131423,0.006590977968571753,1460
59129,1.43490004260739,103.830267560125,YISHUN,127033,73161,53872,100097,0.005019951771913034,1112
59109,1.4343984933093,103.83322945585378,YISHUN,51830,25761,26069,38795,0.00194560305495036,431
59239,1.43560781996531,103.83684372359264,YISHUN,317121,381013,-63892,349067,0.017506014217872335,3879
59249,1.43436086302643,103.8394374423364,YISHUN,154241,138206,16035,146223,0.007333210864905439,1625
59189,1.43425361497792,103.84204166750071,YISHUN,66130,132328,-66198,99229,0.004976420815560491,1102
59199,1.43609553700432,103.84224938363205,YISHUN,41097,105080,-63983,73088,0.0036654268869754326,812
59209,1.43856611102095,103.84021166701386,YISHUN,61055,100250,-39195,80652,0.004044768078047594,896
59211,1.44037027798466,103.8381736110171,YISHUN,95268,59980,35288,77624,0.0038929112395274324,862
75469,1.36626888891089,103.93315812393162,TAMPINES,4721,3498,1223,4109,0.00017150354810747568,44
75499,1.366074,103.936768,TAMPINES,32080,12398,19682,22239,0.0009282227808133734,241
75489,1.363941111,103.9381689,TAMPINES,75117,9610,65507,42363,0.001768168607563152,459
75479,1.361776111,103.9381889,TAMPINES,62445,11400,51045,36922,0.0015410693607262635,400
75471,1.361598056,103.9379408,TAMPINES,15506,112931,-97425,64218,0.0026803637995536315,696
75481,1.363804,103.93794,TAMPINES,12650,96783,-84133,54716,0.002283764453212129,593
75491,1.365746,103.936676,TAMPINES,11916,46442,-34526,29179,0.0012178880579771312,316
81131,1.31431505362846,103.89221613925537,GEYLANG,17820,19245,-1425,18532,0.0012377747865703439,69
53421,1.345658889,103.8553811,BISHAN,28370,30957,-2587,29663,0.003892287698885496,339
55329,1.37901970079676,103.84722527828754,ANG MO KIO,21040,3217,17823,12128,0.0007195287324114292,116
64141,1.36467309909964,103.90820496724626,PAYA LEBAR,19080,29199,-10119,24139,0.03398561957337411,0
64151,1.36812309444086,103.90984810962769,PAYA LEBAR,20102,43046,-22944,31574,0.04445345508967704,0
64161,1.37190805558492,103.91142888889905,PAYA LEBAR,11441,13264,-1823,12352,0.01739054529890704,0
64171,1.37400500001195,103.91234999996988,PAYA LEBAR,659,108,551,383,0.0005392308006380663,0
64181,1.37652001172486,103.913361893323,PAYA LEBAR,92,232,-140,162,0.00022808195745004371,0
64191,1.37946639129442,103.91593239926291,PAYA LEBAR,218,739,-521,478,0.0006729825658093882,0
73021,1.37990824811851,103.91860651287472,PAYA LEBAR,5004,7815,-2811,6409,0.009023316452452655,0
73031,1.37606329708152,103.920020388391,PAYA LEBAR,8191,15629,-7438,11910,0.01676824761253099,0
74051,1.366363,103.929336,PAYA LEBAR,17305,22496,-5191,19900,0.02801747502009796,0
75269,1.35917286418935,103.93814214622792,TAMPINES,30564,13750,16814,22157,0.0009248002227834846,240
75261,1.35801998380195,103.93796778680796,TAMPINES,14036,77435,-63399,45735,0.0019089108719141882,496
74059,1.366122,103.929222,PAYA LEBAR,19121,15867,3254,17494,0.024630035577969535,0
74039,1.367076,103.925908,PAYA LEBAR,3764,4315,-551,4039,0.005686561889757571,0
74029,1.3700705233294,103.92288994719686,PAYA LEBAR,4110,2284,1826,3197,0.004501098876344381,0
74019,1.37358500000858,103.92015138898552,PAYA LEBAR,1237,906,331,1071,0.0015078751631419558,0
73039,1.37605781654383,103.919840609252,PAYA LEBAR,13266,9213,4053,11239,0.015823537776426182,0
73029,1.37988665914102,103.91817387962283,PAYA LEBAR,6659,3542,3117,5100,0.0071803579197235986,0
64199,1.37918375863113,103.91568109069192,PAYA LEBAR,124,131,-7,127,0.00017880499133429354,0
64189,1.37693109577247,103.91392221641736,PAYA LEBAR,230,194,36,212,0.0002984776233296868,0
64179,1.37420776153231,103.91287632675001,PAYA LEBAR,728,1558,-830,1143,0.0016092449220086419,0
64169,1.37131499866835,103.91146527121292,PAYA LEBAR,16610,9897,6713,13253,0.018659075198058206,0
64159,1.36751138265993,103.9099923734176,PAYA LEBAR,38234,20545,17689,29389,0.04137716449073663,0
64149,1.36508805596971,103.90890305599302,PAYA LEBAR,22663,15795,6868,19229,0.027072765183993153,0
64139,1.363239,103.906656,PAYA LEBAR,341,340,1,340,0.0004786905279815732,0
55321,1.37836333298131,103.84722527801875,ANG MO KIO,374,37031,-36657,18702,0.0011095503259860283,180
09139,1.303528,103.823585,ORCHARD,13505,7860,5645,10682,0.0030151548082432674,2
13189,1.30038166697497,103.82414749997376,RIVER VALLEY,6331,5081,1250,5706,0.0054308306715346805,29
13179,1.29925749997453,103.82665250000115,RIVER VALLEY,12703,5943,6760,9323,0.008873402444920755,48
13169,1.29910305180416,103.82839289158527,RIVER VALLEY,3965,1167,2798,2566,0.0024422557839393604,13
13171,1.29906809120339,103.82650703485064,TANGLIN,7636,16998,-9362,12317,0.006164945450468464,62
13181,1.30023223661153,103.82403473005562,TANGLIN,3713,5214,-1501,4463,0.002233835474989101,22
29039,1.31791472290937,103.73590151832454,JURONG EAST,4542,34704,-30162,19623,0.00191375735335638,150
29029,1.3136694444723,103.73497081366901,JURONG EAST,34570,128781,-94211,81675,0.007965455426559768,626
29019,1.30808999973571,103.73376586792706,JURONG EAST,12525,58477,-45952,35501,0.00346227894824975,272
29041,1.30630499421009,103.73605370521642,JURONG EAST,3067,14551,-11484,8809,0.0008591086238453015,67
29121,1.30670185792468,103.73955130573647,JURONG EAST,8198,15521,-7323,11859,0.001156563647426658,90
29051,1.30462052831604,103.74284927023315,JURONG EAST,1198,2816,-1618,2007,0.00019573515814025658,15
29119,1.30075962146214,103.74720096588953,JURONG EAST,4241,10872,-6631,7556,0.0007369082485838459,57
29109,1.29874917121117,103.74969618348408,JURONG EAST,9339,4629,4710,6984,0.0006811232408826866,53
29099,1.29938668393663,103.75207185742923,JURONG EAST,12723,3445,9278,8084,0.0007884021018464545,61
29089,1.30146754204298,103.75270485878043,JURONG EAST,10792,1642,9150,6217,0.0006063206169197683,47
29139,1.30295846509397,103.75137448307609,JURONG EAST,20011,2344,17667,11177,0.001090050753629122,85
29149,1.30169278947484,103.7484455108314,JURONG EAST,31499,3267,28232,17383,0.0016952985819392527,133
29071,1.30422665161292,103.75179382878862,JURONG EAST,2307,29578,-27271,15942,0.0015547632740767166,122
29081,1.30177859797596,103.75284433363814,JURONG EAST,1741,11907,-10166,6824,0.0006655190429243203,52
29091,1.29941886215176,103.75254392626566,JURONG EAST,3704,14219,-10515,8961,0.0008739326119057495,68
29101,1.29856077859667,103.74997666563225,JURONG EAST,4489,12231,-7742,8360,0.0008153193433246363,64
29111,1.30002583301409,103.74685194400729,JURONG EAST,4365,14961,-10596,9663,0.0009423960304480814,74
29069,1.30296947780325,103.74607238005542,JURONG EAST,2314,3057,-743,2685,0.00026185794698883354,20
29059,1.3043728024167,103.74252500205836,JURONG EAST,4206,2006,2200,3106,0.00030291649286678474,23
29129,1.30639194302217,103.73949183679694,JURONG EAST,10990,10141,849,10565,0.0010303646964383711,80
29049,1.3059832127393,103.73668670651571,JURONG EAST,16776,3856,12920,10316,0.0010060806633656635,79
29011,1.3085474999723,103.73362194401842,JURONG EAST,52740,11467,41273,32103,0.003130884794108947,246
29021,1.31267499889159,103.73450231627747,JURONG EAST,53266,31261,22005,42263,0.0041217513644652036,323
29031,1.31653138767966,103.73538661201253,JURONG EAST,90590,17408,73182,53999,0.0052663192847113675,413
21511,1.3331199693958,103.71107697488075,JURONG WEST,4441,29388,-24947,16914,0.0006948695057334951,90
21521,1.33413893275864,103.71458530428906,JURONG WEST,3377,27763,-24386,15570,0.0006396546177291308,83
21531,1.33187576098508,103.71634483335832,JURONG WEST,1760,15353,-13593,8556,0.00035150192095635474,45
21541,1.33138075779669,103.71986360869532,JURONG WEST,3163,7483,-4320,5323,0.00021868217920180882,28
21049,1.32107250538852,103.72024520956326,BOON LAY,2529,13551,-11022,8040,0.01072553437573788,0
21159,1.31868562417111,103.72042922086165,BOON LAY,6565,19718,-13153,13141,0.017530379008901927,0
21149,1.315633,103.719896,JURONG EAST,35514,60119,-24605,47816,0.004663314559857752,366
21071,1.31394221438857,103.72226742161243,JURONG EAST,52633,18696,33937,35664,0.003478175724919836,273
21051,1.312256111,103.7304481,JURONG EAST,7196,8234,-1038,7715,0.0007524149203049724,59
21059,1.311953889,103.7301381,JURONG EAST,10131,13458,-3327,11794,0.0011502244420060718,90
21079,1.31342751032359,103.72279763377816,JURONG EAST,31119,67590,-36471,49354,0.0048133099127325475,378
21141,1.31517431113868,103.71957368500223,JURONG EAST,42244,18815,23429,30529,0.0029773784966935194,234
21151,1.3169920318205,103.71988944330612,BOON LAY,33232,8023,25209,20627,0.02751686536919717,0
21041,1.3209197220107,103.72012027797446,BOON LAY,13006,4246,8760,8626,0.011507271085213303,0
21549,1.33088280586201,103.71899585412747,BOON LAY,6531,1927,4604,4229,0.005641577720770584,0
21539,1.331311,103.716354,JURONG WEST,15637,1830,13807,8733,0.0003587735245105009,46
21529,1.3340830392462,103.71509707566638,JURONG WEST,25590,2854,22736,14222,0.000584275399700944,76
21519,1.33295908040191,103.71129155158583,JURONG WEST,24169,4210,19959,14189,0.0005829196770044083,76
67179,1.38741393896265,103.8979957397525,SENGKANG,89332,52432,36900,70882,0.0054779174207156035,670
59169,1.4304570083984,103.83769416711105,YISHUN,327311,29583,297728,178447,0.008949272544057916,1983
59179,1.43221439515231,103.83988331688866,YISHUN,120412,90326,30086,105369,0.005284347165796223,1171
59261,1.43755803458153,103.83159143616113,YISHUN,103730,133908,-30178,118819,0.005958876385775146,1320
59271,1.4362831713903,103.82855161345292,YISHUN,80695,70793,9902,75744,0.0037986276013445047,841
59511,1.42716904966997,103.82895211582186,YISHUN,116846,80107,36739,98476,0.004938657209415946,1094
59171,1.43226509746155,103.84019665786346,YISHUN,176046,153489,22557,164767,0.008263208623662997,1831
59161,1.43014843981169,103.83793159453417,YISHUN,22944,93481,-70537,58212,0.002919382524417331,646
59072,1.429383056,103.8354931,YISHUN,172950,1741335,-1568385,957142,0.04800150532855516,10637
59811,1.427487,103.852056,YISHUN,18193,44291,-26098,31242,0.001566813523463311,347
59819,1.42696,103.851955,YISHUN,32168,1816,30352,16992,0.0008521636063852691,188
59621,1.43416283001882,103.84410555917717,YISHUN,52496,55318,-2822,53907,0.0027034830231527016,599
59389,1.43202071867504,103.84208246442347,YISHUN,135241,209320,-74079,172280,0.008639992120295089,1914
59639,1.42318166665872,103.84412388893058,YISHUN,151828,91896,59932,121862,0.006111485487365917,1354
59579,1.420294,103.843953,YISHUN,256168,104912,151256,180540,0.009054238317843485,2006
59581,1.41903123253322,103.84618997941803,YISHUN,63441,72161,-8720,67801,0.0034002792300216354,753
59381,1.43181131616813,103.84196021620254,YISHUN,98544,119742,-21198,109143,0.005473616554361313,1213
59289,1.42166630737691,103.84138894371273,YISHUN,25931,79096,-53165,52513,0.0026335727084574882,583
59299,1.41910065823939,103.84101934062127,YISHUN,14810,79826,-65016,47318,0.0023730389316700897,525
59449,1.41552972203074,103.83953916700452,YISHUN,90085,221890,-131805,155987,0.007822883973000174,1733
59589,1.4196568772859,103.84477283466764,YISHUN,26908,34756,-7848,30832,0.001546251666200013,342
59761,1.41849608053432,103.84326740385671,YISHUN,177100,50309,126791,113704,0.00570235467869766,1263
59719,1.41756544907262,103.84200497226853,YISHUN,128096,49035,79061,88565,0.004441611923229246,984
59291,1.4189297001887,103.8407248899634,YISHUN,99380,38690,60690,69035,0.0034621654052970252,767
59281,1.4228063053424,103.84070404095088,YISHUN,126637,41835,84802,84236,0.0042245088010516435,936
59359,1.42844102693712,103.84071821797886,YISHUN,22777,65870,-43093,44323,0.002222837071905266,492
59351,1.42877888900017,103.8402288889874,YISHUN,73555,20106,53449,46830,0.0023485653064396275,520
59439,1.417834,103.838374,YISHUN,176069,75494,100575,125781,0.006308026752280222,1397
59429,1.417434,103.835047,YISHUN,166070,267942,-101872,217006,0.010883039993364037,2411
59421,1.41762836917061,103.8351341252188,YISHUN,241528,115903,125625,178715,0.00896271297758612,1986
59431,1.417805,103.8376805,YISHUN,67757,123256,-55499,95506,0.004789709121435471,1061
59711,1.418198,103.8427135,YISHUN,63849,210968,-147119,137408,0.00689113093374453,1527
59571,1.42072559126348,103.84373330710623,YISHUN,64525,221648,-157123,143086,0.0071758875814055215,1590
59631,1.42333778088573,103.84397389045573,YISHUN,30378,71790,-41412,51084,0.0025619071132641884,567
59221,1.43902299324239,103.83502785005078,YISHUN,6353,5379,974,5866,0.0002941850114792837,65
59159,1.43055466220788,103.8346706884974,YISHUN,106684,176931,-70247,141807,0.007111744616918306,1576
59229,1.43901589576688,103.83416399362906,YISHUN,14332,14676,-344,14504,0.0007273882384070117,161
59481,1.41542424800444,103.83647690158537,YISHUN,37006,47907,-10901,42456,0.002129205395050199,471
59499,1.41325017295345,103.83459754405295,YISHUN,30109,32374,-2265,31241,0.001566763372591937,347
59441,1.41588388901051,103.83948333301474,YISHUN,131951,11382,120569,71666,0.00359411234788175,796
59369,1.42214126973318,103.83683836680166,YISHUN,26999,32775,-5776,29887,0.0014988590927516796,332
59379,1.41946852245611,103.83823983239508,YISHUN,54649,52936,1713,53792,0.0026977156729447033,597
59008,1.4285384902718,103.8361105319593,YISHUN,166193,46211,119982,106202,0.00532612284165068,1180
55349,1.38479144169995,103.8364930927339,ANG MO KIO,1853,2988,-1135,2420,0.00014357351026019613,23
55339,1.38708225951205,103.83711644936153,ANG MO KIO,613,5027,-4414,2820,0.0001673046689808897,27
55351,1.3897367880855,103.83696395007934,ANG MO KIO,577,4811,-4234,2694,0.00015982935398387124,25
55371,1.388614367271,103.83440450730951,ANG MO KIO,2605,3326,-721,2965,0.00017590721401714113,28
55381,1.3899041699795,103.83624640000222,ANG MO KIO,9748,4426,5322,7087,0.0004204568046338884,68
55361,1.38983685641152,103.83860500061255,ANG MO KIO,3963,2027,1936,2995,0.00017768705092119315,28
55331,1.38692246241021,103.8371410383723,ANG MO KIO,3557,980,2577,2268,0.00013455566994633258,21
55341,1.384975,103.836684,ANG MO KIO,2386,2542,-156,2464,0.00014618393771947242,23
65091,1.4039796271467,103.90655641325277,PUNGGOL,16562,8102,8460,12332,0.0016760087073082923,292
65629,1.41645968650579,103.90252132088521,PUNGGOL,6183,15261,-9078,10722,0.001457197969490716,254
65639,1.41755237944481,103.90530849057907,PUNGGOL,1873,2981,-1108,2427,0.0003298469942132035,57
65689,1.418378,103.907847,PUNGGOL,450,2315,-1865,1382,0.0001878238755676338,32
65139,1.4206253932076,103.91053469680278,PUNGGOL,34402,35032,-630,34717,0.004718293406716022,823
65681,1.418239,103.907934,PUNGGOL,1678,99,1579,888,0.00012068567402609175,21
65099,1.40446781720997,103.90711426733175,PUNGGOL,11147,10738,409,10942,0.001487097573416099,259
67579,1.39483619700068,103.8734686374815,SENGKANG,39437,23292,16145,31364,0.002423879151030222,296
67571,1.39515796674426,103.87391924861367,SENGKANG,16134,25672,-9538,20903,0.0016154299800403243,197
55269,1.392529,103.837048,ANG MO KIO,34795,34211,584,34503,0.0020469904233502262,332
55259,1.391294,103.838855,ANG MO KIO,23206,5153,18053,14179,0.0008412102487517856,136
55249,1.389369,103.841052,ANG MO KIO,941,623,318,782,4.639441529895594e-05,7
55241,1.38932985258763,103.84071031595586,ANG MO KIO,1781,4356,-2575,3068,0.00018201798738771974,29
55251,1.39093600499761,103.83885575492444,ANG MO KIO,4159,13083,-8924,8621,0.0005114657983277483,83
55261,1.3924244439738,103.83649555600854,ANG MO KIO,43743,45494,-1751,44618,0.002647092099499765,429
59669,1.42623639393056,103.83784276257873,YISHUN,8474,561,7913,4517,0.00022653148599589577,50
59619,1.42335199999945,103.83687299997104,YISHUN,107049,124079,-17030,115564,0.005795635299453109,1284
59611,1.42362582861812,103.83666744952643,YISHUN,77774,74655,3119,76214,0.0038221985108902365,847
59661,1.42631491614237,103.83762861110566,YISHUN,836,10204,-9368,5520,0.0002768328099839151,61
58101,1.44667277800811,103.82282277802054,SEMBAWANG,47102,55289,-8187,51195,0.006751200301301738,692
58111,1.45096272310028,103.82075231895968,SEMBAWANG,97527,34316,63211,65921,0.008693151187852561,892
58131,1.4562533329966,103.82045999997707,SEMBAWANG,3195,6883,-3688,5039,0.0006645043132778485,68
47119,1.46646104980927,103.81068004378777,SEMBAWANG,44426,88136,-43710,66281,0.008740625201105195,897
47109,1.46608416701086,103.80861861101391,SEMBAWANG,8416,19852,-11436,14134,0.0018638825092020463,191
47099,1.46400708429355,103.80529911397457,SEMBAWANG,16665,23230,-6565,19947,0.002630455950973059,269
47089,1.46227877192855,103.80387918503345,SEMBAWANG,39452,25571,13881,32511,0.004287299013490005,440
47069,1.45593908069502,103.79877069336828,WOODLANDS,46463,22544,23919,34503,0.0013712894989938592,349
47059,1.45396450182247,103.7954729366899,WOODLANDS,64289,30882,33407,47585,0.0018912213665369037,482
47049,1.45246524141338,103.7925804884025,WOODLANDS,126222,44135,82087,85178,0.0033853200285569062,863
47039,1.45156922188356,103.78905216062749,WOODLANDS,51253,1976,49277,26614,0.001057748564653003,269
47029,1.45096550351717,103.78252315836185,WOODLANDS,1069,1210,-141,1139,4.5268490837144754e-05,11
47201,1.448472,103.7848997,WOODLANDS,159311,162407,-3096,160859,0.006393190665120517,1631
47019,1.45075155241442,103.77892930711522,WOODLANDS,10813,5566,5247,8189,0.000325464154052132,83
46139,1.4461801595519,103.7772632603031,WOODLANDS,5151,4141,1010,4646,0.00018465092926196183,47
46129,1.44378798401059,103.77675415681387,WOODLANDS,118021,73907,44114,95964,0.0038139995212429843,973
46501,1.43796940271606,103.77118912980488,WOODLANDS,16605,29361,-12756,22983,0.0009134378620808585,233
46511,1.43438229479103,103.77255675974702,WOODLANDS,35465,99921,-64456,67693,0.0026903950397180335,686
46121,1.44387999997343,103.7764388889843,WOODLANDS,65640,63734,1906,64687,0.002570924378211047,655
46131,1.44627465890953,103.77703712251773,WOODLANDS,4677,4147,530,4412,0.00017535081788716653,44
47011,1.45076766255392,103.77863124035153,WOODLANDS,4905,7857,-2952,6381,0.0002536068832588417,64
47021,1.4511345744486,103.78327492635378,WOODLANDS,827,1554,-727,1190,4.729543818806168e-05,12
47031,1.45176361051626,103.78814404102567,WOODLANDS,1783,51584,-49801,26683,0.0010604909051865966,270
47041,1.4525686110144,103.79164305597227,WOODLANDS,42277,146455,-104178,94366,0.0037504885042475874,956
47051,1.45449749999994,103.79560277796767,WOODLANDS,29181,51597,-22416,40389,0.0016052230697290954,409
47061,1.45605441023441,103.79808423496016,SEMBAWANG,15128,48255,-33127,31691,0.004179163761081226,428
47081,1.46202336398517,103.80383405130847,SEMBAWANG,23334,40911,-17577,32122,0.004236000704725352,434
47091,1.4645966256977,103.80602561139148,SEMBAWANG,25803,14550,11253,20176,0.002660654698292096,273
47101,1.46653722200693,103.8090658329841,SEMBAWANG,17169,15896,1273,16532,0.002180112186368206,223
47111,1.46619184828781,103.81100178837575,SEMBAWANG,64848,32898,31950,48873,0.0064449929158222445,661
58139,1.45637564424183,103.82074569870127,SEMBAWANG,6636,2481,4155,4558,0.0006010737566819673,61
58119,1.45099925490468,103.82102323159111,SEMBAWANG,68063,150721,-82658,109392,0.014425770160367217,1480
58109,1.44667607916689,103.82309298513003,SEMBAWANG,49786,21049,28737,35417,0.004670519798245993,479
46281,1.43878695707764,103.79002589502426,WOODLANDS,116434,48357,68077,82395,0.0032747122937019685,835
46391,1.43921765358175,103.79299454006805,WOODLANDS,187780,86520,101260,137150,0.00545089861133837,1390
46401,1.44088595099083,103.79545806673289,WOODLANDS,24035,30242,-6207,27138,0.0010785744550820318,275
46411,1.44270591766599,103.79441916127091,WOODLANDS,60948,107744,-46796,84346,0.003352252965890967,855
46731,1.44852127932275,103.8043021981092,WOODLANDS,45275,15904,29371,30589,0.0012157312258274109,310
46741,1.44632701434368,103.80719269495765,SEMBAWANG,44309,21487,22822,32898,0.004338333577736587,445
47621,1.44689218119453,103.80982770058664,SEMBAWANG,70135,43053,27082,56594,0.00746317862783222,766
58381,1.44797049342873,103.81337787352544,SEMBAWANG,77531,42354,35177,59942,0.007904686951081721,811
58229,1.44875084068886,103.8168059210019,SEMBAWANG,42890,18761,24129,30825,0.004064962384756833,417
58221,1.44859264769928,103.81706577986397,SEMBAWANG,16451,41470,-25019,28960,0.003819020621656379,391
58389,1.44773992017207,103.8135666814871,SEMBAWANG,36411,70997,-34586,53704,0.007082067799220793,726
47629,1.44667808186871,103.80985736845511,SEMBAWANG,33534,81600,-48066,57567,0.007591490335873369,779
46749,1.44598746959694,103.80719081852185,WOODLANDS,25483,63983,-38500,44733,0.0017778712911483727,453
46739,1.44847350274561,103.80400338022199,WOODLANDS,16360,50811,-34451,33585,0.0013348044466773544,340
46419,1.44379,103.79386,WOODLANDS,154430,74910,79520,114670,0.004557452014306751,1162
46409,1.44063323115091,103.79570596322442,WOODLANDS,24620,20230,4390,22425,0.0008912606734178851,227
46399,1.43896035246776,103.79423705109248,WOODLANDS,135623,269265,-133642,202444,0.008045947637431898,2052
46289,1.43872239825648,103.79091198323174,WOODLANDS,79640,148748,-69108,114194,0.0045385338390315265,1157
58321,1.45020573824638,103.81614518346868,SEMBAWANG,47490,15746,31744,31618,0.004169537086171664,427
58271,1.44702783502401,103.81470654183288,SEMBAWANG,94464,43617,50847,69040,0.009104460763783025,934
58281,1.4450136750226,103.8162666133863,SEMBAWANG,76712,55719,20993,66215,0.00873192163200888,896
58371,1.44449009584233,103.8190895319006,SEMBAWANG,67384,41832,25552,54608,0.00720128032138852,739
58241,1.44722064601498,103.82018490260376,SEMBAWANG,12753,43395,-30642,28074,0.003702181800151284,379
58249,1.44711722202289,103.82118555599861,SEMBAWANG,1492,11722,-10230,6607,0.000871280015444879,89
58379,1.44428574142951,103.81900511225648,SEMBAWANG,33453,85639,-52186,59546,0.007852465536503823,805
58289,1.44485960840447,103.81627162679553,SEMBAWANG,60541,98914,-38373,79727,0.010513779596091096,1079
58279,1.44658462255674,103.81456918653721,SEMBAWANG,57621,103768,-46147,80694,0.010641300070578032,1092
58329,1.45050186875947,103.81655964918443,SEMBAWANG,18098,54419,-36321,36258,0.004781424368094509,490
43581,1.36251939522797,103.75138384429646,BUKIT BATOK,43947,80841,-36894,62394,0.005020361777597828,388
58481,1.45305905176825,103.82267933798676,SEMBAWANG,27486,30985,-3499,29235,0.0038552854928910305,395
58491,1.45272174340224,103.82431343665893,SEMBAWANG,3484,18298,-14814,10891,0.00143622077315123,147
58501,1.4507187825944,103.82708492151545,SEMBAWANG,2560,42059,-39499,22309,0.0029419382268139555,301
58071,1.45528422069638,103.83388976874676,SEMBAWANG,312,2196,-1884,1254,0.00016536781283001033,16
58081,1.45825194403092,103.83594609403143,SEMBAWANG,4645,26952,-22307,15798,0.002083317948236446,213
58091,1.46211498021096,103.8379191742591,SEMBAWANG,23171,24250,-1079,23710,0.003126691261722125,320
58099,1.460299,103.837391,SEMBAWANG,19003,20435,-1432,19719,0.0026003890759130573,266
58089,1.45873255930273,103.83654216993519,SEMBAWANG,16452,2919,13533,9685,0.0012771828287549043,131
58079,1.45500446219905,103.83381218856621,SEMBAWANG,5323,428,4895,2875,0.00037913274472590086,38
58509,1.45059927113154,103.82696425665894,SEMBAWANG,54375,3263,51112,28819,0.00380042663313243,390
58499,1.45205869701978,103.82428769521943,SEMBAWANG,20664,8896,11768,14780,0.0019490719885387183,200
58489,1.45285946613506,103.82251092163827,SEMBAWANG,28390,32604,-4214,30497,0.004021708283793321,412
58521,1.44819389,103.8326,SEMBAWANG,95456,58437,37019,76946,0.010147042843714493,1041
58621,1.445953,103.834031,SEMBAWANG,82397,96993,-14596,89695,0.011828282274152932,1214
58531,1.44543806,103.8323,SEMBAWANG,47753,15981,31772,31867,0.0042023732786714025,431
58539,1.44576806,103.832311,SEMBAWANG,16239,52458,-36219,34348,0.004529548353337476,464
58529,1.44801889,103.832461,SEMBAWANG,60155,86545,-26390,73350,0.009672830200224289,992
71031,1.33913918063035,103.8968074607421,HOUGANG,22919,4312,18607,13615,0.0007159271522168922,162
71191,1.34114100497371,103.89814797322435,HOUGANG,2836,15730,-12894,9283,0.00048813453940722807,111
71181,1.34332868665716,103.8989460984825,HOUGANG,5087,32883,-27796,18985,0.0009983016514754095,227
71041,1.34652497125332,103.89845248326446,HOUGANG,7988,19979,-11991,13983,0.000735277955890474,167
73041,1.35049911274132,103.89882183551578,PAYA LEBAR,36231,64218,-27987,50224,0.07071103846278393,0
73019,1.35196515809661,103.8994408560332,PAYA LEBAR,21757,23549,-1792,22653,0.03189346038343111,0
73049,1.35075966304764,103.89911545547028,PAYA LEBAR,31521,5156,26365,18338,0.02581831441801791,0
71049,1.34609209274348,103.89881549663342,PAYA LEBAR,15424,1124,14300,8274,0.011649074789763344,0
71189,1.34494057674135,103.89909457528678,HOUGANG,31206,3282,27924,17244,0.0009067534199653389,206
46691,1.43823132518893,103.79587886684328,WOODLANDS,45858,77926,-32068,61892,0.0024598397145676586,627
46689,1.43587054546915,103.79601265965388,WOODLANDS,15260,59917,-44657,37588,0.0014938999416914812,381
46951,1.43143692171434,103.79133300087983,WOODLANDS,16577,40800,-24223,28688,0.001140177756923625,290
46681,1.4357329097814,103.79577696652271,WOODLANDS,63105,9972,53133,36538,0.001452168672702015,370
46699,1.43769989889611,103.79566316043969,WOODLANDS,49603,36632,12971,43117,0.001713644880970299,437
58461,1.42965591818928,103.79044555841314,WOODLANDS,12105,19105,-7000,15605,0.0006202061453148761,158
58479,1.4283363281994,103.78977121023533,WOODLANDS,155,1000,-845,577,2.293232591135428e-05,5
58449,1.4270920469684,103.78906720963263,WOODLANDS,2905,4460,-1555,3682,0.00014633764992306146,37
58439,1.42857896419364,103.78833922258168,WOODLANDS,1150,640,510,895,3.55709388053069e-05,9
46971,1.43187555599274,103.79034249996818,WOODLANDS,57898,134239,-76341,96068,0.0038181329040762268,974
47501,1.43046208317462,103.79470229416464,WOODLANDS,66285,95091,-28806,80688,0.0032068691735448076,818
47511,1.43190354583508,103.79644777764182,WOODLANDS,61632,59969,1663,60800,0.0024164391948186138,616
47521,1.43165346145517,103.79813585749302,WOODLANDS,143555,141090,2465,142322,0.005656454919160769,1443
47539,1.42870555201688,103.79766275675345,WOODLANDS,42160,20459,21701,31309,0.0012443469531344734,317
46979,1.43130555598072,103.79065444401148,WOODLANDS,137860,60479,77381,99169,0.003941379251825117,1005
47491,1.431021111,103.8004889,WOODLANDS,64583,31831,32752,48207,0.0019159421754049494,488
47551,1.43472623786722,103.80188755233279,WOODLANDS,144598,108811,35787,126704,0.005035732100991738,1284
47541,1.43789201937501,103.80334162830194,WOODLANDS,45534,62011,-16477,53772,0.0021371179010491203,545
47591,1.43973872693624,103.8025081158021,WOODLANDS,83738,135551,-51813,109644,0.004357698340077172,1111
46779,1.44071357576488,103.80070754495145,WOODLANDS,998759,1982595,-983836,1490677,0.05924556463181952,15115
47549,1.4379048516895,103.80352352573782,WOODLANDS,84674,73220,11454,78947,0.0031376747551537026,800
47559,1.43461254485308,103.80204564158956,WOODLANDS,93059,111173,-18114,102116,0.004058505013455552,1035
47499,1.430773889,103.8006081,WOODLANDS,16524,61392,-44868,38958,0.0015483493117063086,395
47529,1.431536111,103.7981161,WOODLANDS,68196,120870,-52674,94533,0.0037571257632201976,958
47509,1.430331111,103.7948411,WOODLANDS,50919,58796,-7877,54857,0.002180240212338235,556
46301,1.44274264517274,103.78280019667034,WOODLANDS,14841,21663,-6822,18252,0.0007254086872340352,185
46311,1.44234108679072,103.78051008341868,WOODLANDS,9924,30773,-20849,20348,0.0008087122489501506,206
46319,1.44229032785462,103.7802984405171,WOODLANDS,27401,11098,16303,19249,0.0007650335207411759,195
46309,1.44317008649619,103.78254975765708,WOODLANDS,31969,14487,17482,23228,0.0009231751581784006,235
46761,1.43964444400977,103.79740027801978,WOODLANDS,148666,61795,86871,105230,0.004182268034058597,1067
46771,1.44088808355944,103.80018670656507,WOODLANDS,826974,192275,634699,509624,0.020254529740464496,5167
47599,1.4399264222862,103.80263149734922,WOODLANDS,77310,48074,29236,62692,0.0024916349671310614,635
47641,1.43923143369845,103.80372860775078,WOODLANDS,16047,17941,-1894,16994,0.0006754106525780842,172
47751,1.439206111,103.8058639,WOODLANDS,6963,72730,-65767,39846,0.0015836420420516856,404
47651,1.4416971090803,103.80525516994503,WOODLANDS,11927,68841,-56914,40384,0.001605024349400574,409
47661,1.44445189092675,103.80275437815418,WOODLANDS,7157,13240,-6083,10198,0.00040530998205197735,103
47671,1.446563,103.803336,WOODLANDS,108237,107875,362,108056,0.0042945847637388184,1095
47681,1.44457845619804,103.80448623998072,WOODLANDS,62521,43047,19474,52784,0.0020978507641333174,535
47659,1.44146349893337,103.80545909188204,WOODLANDS,65611,13126,52485,39368,0.0015646443786450524,399
47759,1.439225,103.805645,WOODLANDS,79232,9453,69779,44342,0.0017623313614580094,449
47649,1.43909453192901,103.8036760000029,WOODLANDS,24095,11259,12836,17677,0.0007025558494540894,179
46769,1.43935103379454,103.79735798460473,WOODLANDS,57453,142341,-84888,99897,0.0039703129316578135,1012
18051,1.29863776004531,103.7873441662514,QUEENSTOWN,21655,2886,18769,12270,0.0010655585089753548,102
18021,1.29645297711413,103.7889243029247,QUEENSTOWN,3164,12993,-9829,8078,0.000701514395721509,67
18029,1.29609811481527,103.78918045190079,QUEENSTOWN,14233,12539,1694,13386,0.001162474833019079,111
18069,1.29649064143644,103.7875521182857,QUEENSTOWN,1229,887,342,1058,9.187945415614713e-05,8
18089,1.29480675923682,103.78757357729762,QUEENSTOWN,7839,10347,-2508,9093,0.0007896596187541077,75
18099,1.29393169432811,103.78953616896972,QUEENSTOWN,1536,852,684,1194,0.00010369004561667266,9
18081,1.29478519265463,103.78733754155819,QUEENSTOWN,6355,102,6253,3228,0.0002803278620189442,26
18061,1.29671588928647,103.78738045694247,QUEENSTOWN,3905,106,3799,2005,0.000174119381458483,16
18059,1.29849138898115,103.78720666698497,QUEENSTOWN,2757,5089,-2332,3923,0.00034068345808560037,32
46421,1.44087032562722,103.79353779670151,WOODLANDS,10068,107176,-97108,58622,0.00232987661971475,594
46431,1.44397726846722,103.79225565189952,WOODLANDS,9970,132175,-122205,71072,0.002824690237732706,720
46441,1.44219465826527,103.78973710977665,WOODLANDS,10727,133106,-122379,71916,0.002858234229187096,729
46251,1.4409223616912,103.78908630031805,WOODLANDS,34650,17244,17406,25947,0.001031239272828266,263
46449,1.44235503567241,103.79003727703439,WOODLANDS,133209,16981,116228,75095,0.0029845806140609177,761
46439,1.44413536712492,103.79265007190847,WOODLANDS,111765,8955,102810,60360,0.0023989518059087424,612
46429,1.44071444400658,103.7931500000338,WOODLANDS,123288,14609,108679,68948,0.0027402738421768713,699
46008,1.436849,103.785737,WOODLANDS,938917,813364,125553,876140,0.034821365726124674,8883
46559,1.435244,103.781503,WOODLANDS,19946,76281,-56335,48113,0.0019122062332287495,487
46569,1.434395,103.777132,WOODLANDS,16581,93866,-77285,55223,0.002194786540385992,559
46579,1.43488583298053,103.77552249997427,WOODLANDS,39618,102756,-63138,71187,0.002829260805288695,721
46589,1.43632306005208,103.7741086340661,WOODLANDS,15051,43298,-28247,29174,0.0011594933728558922,295
46581,1.4364411890996,103.77379636706418,WOODLANDS,6995,11946,-4951,9470,0.0003763763022192808,96
46571,1.43475417848392,103.7758535357882,WOODLANDS,50592,25751,24841,38171,0.001517070731997061,387
46561,1.434717,103.777244,WOODLANDS,55941,8107,47834,32024,0.0012727639601130146,324
46551,1.435184,103.781737,WOODLANDS,57846,20497,37349,39171,0.0015568147977013146,397
46661,1.43759221925392,103.79228928579461,WOODLANDS,32010,53634,-21624,42822,0.0017019203815875441,434
46671,1.43689166982219,103.7946223426922,WOODLANDS,91780,92302,-522,92041,0.003658083551485198,933
46851,1.43612666735899,103.79761267660548,WOODLANDS,77279,53146,24133,65212,0.0025917900127057805,661
46861,1.43515578551993,103.79998340500156,WOODLANDS,89912,71560,18352,80736,0.003208776888698612,818
46871,1.43679116597713,103.80176512304321,WOODLANDS,16035,33484,-17449,24759,0.000984023322771613,251
46879,1.43706616822564,103.80215927133399,WOODLANDS,29545,30529,-984,30037,0.0011937925015586628,304
46869,1.43507671767646,103.80054550817393,WOODLANDS,91258,140721,-49463,115989,0.004609874436970661,1176
46859,1.4362025834102,103.79739593537928,WOODLANDS,49543,87499,-37956,68521,0.0027233031261211555,694
46679,1.43677694401385,103.7948505560336,WOODLANDS,59355,77977,-18622,68666,0.0027290660156482722,696
46669,1.43740934044808,103.79182446445486,WOODLANDS,31967,31767,200,31867,0.0012665241417974468,323
46321,1.43457763941924,103.78655642033898,WOODLANDS,57727,5800,51927,31763,0.0012623907589642044,322
46341,1.43172193690625,103.78630311506315,WOODLANDS,37045,40022,-2977,38533,0.0015314580837820007,390
46351,1.43084888887005,103.78373500001297,WOODLANDS,14538,26702,-12164,20620,0.0008195226348217075,209
46629,1.42946092866646,103.7808172850331,WOODLANDS,38461,107693,-69232,73077,0.0029043770894697342,740
46619,1.42907407993851,103.77775112537243,WOODLANDS,19053,50567,-31514,34810,0.001383490927165065,352
46361,1.4274660260627,103.773787554639,WOODLANDS,15843,100719,-84876,58281,0.0023163238933095994,590
46371,1.42917208793815,103.77253170053454,WOODLANDS,10193,43862,-33669,27027,0.00107416286378886,274
46591,1.43068958976223,103.77322606797722,WOODLANDS,76133,47155,28978,61644,0.0024499831862730037,625
46379,1.42911804399457,103.77294013114384,WOODLANDS,23373,7190,16183,15281,0.000607329068026698,154
46369,1.42760121342773,103.77315906940312,WOODLANDS,83274,39519,43755,61396,0.002440126657978349,622
46611,1.42923412810157,103.77760584579323,WOODLANDS,61480,25717,35763,43598,0.0017327617765740448,442
46621,1.42955535916481,103.78064562823636,WOODLANDS,70032,48230,21802,59131,0.0023501063491582147,599
46359,1.43082500006702,103.7829908333452,WOODLANDS,35972,11792,24180,23882,0.0009491677771489825,242
46349,1.4318970485931,103.78622445675852,WOODLANDS,40686,37030,3656,38858,0.0015443749051358832,394
46329,1.43444810854853,103.78737576801932,WOODLANDS,4242,42601,-38359,23421,0.0009308457628593216,237
45599,1.429146111,103.7745339,WOODLANDS,14262,16151,-1889,15206,0.0006043482630988789,154
46781,1.44267569107428,103.80124424937155,WOODLANDS,22146,21459,687,21802,0.0008665001204841352,221
46791,1.44569499940057,103.79963351229267,WOODLANDS,15990,289431,-273441,152710,0.006069316273696555,1548
46811,1.44379237320988,103.79931523209541,WOODLANDS,31191,51461,-20270,41326,0.0016424632592939809,419
46821,1.44215561041047,103.79755539404626,WOODLANDS,35202,45964,-10762,40583,0.0016129334184757204,411
46831,1.44364527797106,103.7956269439894,WOODLANDS,134884,128336,6548,131610,0.005230716487336805,1334
46841,1.44498571659794,103.79690162812369,WOODLANDS,162108,92264,69844,127186,0.005054888740661188,1289
46799,1.44586617373151,103.79970850070715,WOODLANDS,261815,25455,236360,143635,0.005708638877430454,1456
46789,1.44351138898079,103.80106305603081,WOODLANDS,64236,16851,47385,40543,0.0016113436558475504,411
46071,1.43864652268091,103.77679962439775,WOODLANDS,134831,129304,5527,132067,0.005248879525363649,1339
46011,1.4385198561158,103.7742921156719,WOODLANDS,50248,38657,11591,44452,0.0017667032086854774,450
46019,1.4386733329964,103.7741286109918,WOODLANDS,63839,51922,11917,57880,0.0023003865229621937,586
46079,1.43886731397133,103.77691747568024,WOODLANDS,109494,124624,-15130,117059,0.004652400587274213,1186
45591,1.429215,103.7748931,WOODLANDS,9700,11542,-1842,10621,0.0004221217218448766,107
45581,1.430976111,103.7800619,WOODLANDS,5357,9759,-4402,7558,0.0003003856485927481,76
45589,1.430796944,103.780325,WOODLANDS,8745,6942,1803,7843,0.0003117127073184603,79
15181,1.29108496444522,103.78541356072027,QUEENSTOWN,281,3587,-3306,1934,0.00016795355797541453,16
18241,1.29092304543197,103.78707861052065,QUEENSTOWN,151,22030,-21879,11090,0.0009630842595384421,92
18251,1.29068138903164,103.78845361097359,QUEENSTOWN,25,3079,-3054,1552,0.00013477969078482075,12
18261,1.29015996757499,103.78933806183707,QUEENSTOWN,113,18743,-18630,9428,0.0008187518844840786,78
18271,1.28840699998743,103.78992778459765,QUEENSTOWN,204,18582,-18378,9393,0.0008157123940346787,78
18281,1.28752556916883,103.7912122154174,QUEENSTOWN,329,6786,-6457,3557,0.00030889907224330374,29
18289,1.28738105702672,103.7912059790003,QUEENSTOWN,4716,65,4651,2390,0.00020755377640188248,19
18279,1.28840636755823,103.78976622482348,QUEENSTOWN,17248,25,17223,8636,0.0007499725577433711,71
18269,1.29010333301913,103.78918694399599,QUEENSTOWN,15201,0,15201,7600,0.0006600036404411326,63
18249,1.29072399998624,103.78712700002762,QUEENSTOWN,13292,112,13180,6702,0.0005820189997679566,55
15189,1.29079779477822,103.78550255759306,QUEENSTOWN,4916,955,3961,2935,0.00025488298482825313,24
12121,1.31164833301814,103.7871516670319,QUEENSTOWN,40504,62220,-21716,51362,0.004460408813202296,427
12131,1.3141594439742,103.785061666981,BUKIT TIMAH,1355,11263,-9908,6309,0.001046185378278346,81
12141,1.31574389841394,103.78239154819083,BUKIT TIMAH,5328,20367,-15039,12847,0.002130344516522731,165
12211,1.31721336095462,103.78070712088581,BUKIT TIMAH,4443,19814,-15371,12128,0.0020111168596861277,156
12151,1.31865064467378,103.78127574919664,BUKIT TIMAH,1194,2395,-1201,1794,0.00029748875711386156,23
12169,1.31916549240365,103.77724170687915,BUKIT TIMAH,4962,6350,-1388,5656,0.0009379021238773696,73
12179,1.31679504687757,103.7769949436126,BUKIT TIMAH,22807,30153,-7346,26480,0.004391026916597021,341
12199,1.31547998901343,103.77820622498255,BUKIT TIMAH,8133,8163,-30,8148,0.0013511362279619533,105
12189,1.31642693680141,103.78022402243116,BUKIT TIMAH,6774,967,5807,3870,0.0006417399609981295,49
12149,1.31576900455367,103.78266099158458,BUKIT TIMAH,17358,3427,13931,10392,0.0017232459107732717,134
12139,1.31453185933289,103.78504157068625,BUKIT TIMAH,9521,809,8712,5165,0.0008564824027274778,66
12129,1.31182111096862,103.78732611099163,QUEENSTOWN,33257,29415,3842,31336,0.0027212992206399117,261
44631,1.37961719959059,103.76390959462616,BUKIT PANJANG,75133,647,74486,37890,0.004519082658422829,307
44641,1.38178063199093,103.76285898246775,BUKIT PANJANG,91476,21970,69506,56723,0.0067652659180184255,461
44791,1.38372439268243,103.76068878232401,BUKIT PANJANG,57005,71181,-14176,64093,0.007644274606130758,520
44801,1.38503510909651,103.75908340599958,BUKIT PANJANG,44086,90247,-46161,67166,0.008010786641214773,545
44861,1.3866920101757,103.75877312173013,BUKIT PANJANG,90933,169006,-78073,129969,0.015501204909806195,1056
44951,1.388313,103.761392,BUKIT PANJANG,9194,32640,-23446,20917,0.0024947387692327875,170
44931,1.387703,103.763361,BUKIT PANJANG,32918,56451,-23533,44684,0.005329392702796667,363
44721,1.38679108297845,103.76491900002709,BUKIT PANJANG,27343,38653,-11310,32998,0.003935621260560478,268
44661,1.38447517162011,103.76499586025828,BUKIT PANJANG,71488,132020,-60532,101754,0.012136044782928387,827
44671,1.38377960229632,103.76603097323033,BUKIT PANJANG,15687,17841,-2154,16764,0.0019994167771390952,136
44601,1.38213337099986,103.76845044698479,BUKIT PANJANG,10154,22261,-12107,16207,0.0019329842344961413,131
44349,1.3813330335154,103.7693280970516,BUKIT PANJANG,57283,43279,14004,50281,0.005996938378151446,408
44339,1.38084522961484,103.77114903339667,BUKIT PANJANG,37180,42080,-4900,39630,0.004726609811382864,322
44329,1.38021501052151,103.77257633645274,BUKIT PANJANG,72573,176274,-103701,124423,0.014839741926865761,1011
44301,1.377468,103.77388,BUKIT PANJANG,141193,101338,39855,121265,0.01446309207109117,985
44311,1.37930410199585,103.77434920734999,BUKIT PANJANG,82077,16905,65172,49491,0.005902716279968441,402
44321,1.379874,103.772318,BUKIT PANJANG,66811,57659,9152,62235,0.007422673772682628,505
44331,1.38022107375265,103.77084865060209,BUKIT PANJANG,31149,32179,-1030,31664,0.003776517109957785,257
44341,1.3811702972192,103.76917730998287,BUKIT PANJANG,39628,59817,-20189,49722,0.005930267298551067,404
44609,1.38201455238716,103.76817086367248,BUKIT PANJANG,13231,13873,-642,13552,0.0016163264235140192,110
44679,1.3835337784384,103.76599518745716,BUKIT PANJANG,9096,16798,-7702,12947,0.0015441689938928576,105
44669,1.38428576640159,103.76489752763662,BUKIT PANJANG,92418,70411,22007,81414,0.009710123925912806,661
44829,1.38671416700146,103.7630574999811,BUKIT PANJANG,31646,53475,-21829,42560,0.005076066454010969,345
44959,1.388611,103.762426,BUKIT PANJANG,25823,14376,11447,20099,0.0023971771536458286,163
44819,1.38707539442819,103.76004791400926,BUKIT PANJANG,91660,71733,19927,81696,0.009743757636909777,664
44869,1.38658738981297,103.75886226371927,BUKIT PANJANG,75755,67837,7918,71796,0.008562999697654406,583
44809,1.38500083704863,103.75978425435241,BUKIT PANJANG,85101,43894,41207,64497,0.007692459071530674,524
44799,1.38338692962433,103.7609562427946,BUKIT PANJANG,48542,53206,-4664,50874,0.0060676645860280555,413
44649,1.38207041321308,103.76296296396666,BUKIT PANJANG,13570,38376,-24806,25973,0.0030977601976040154,211
44639,1.38006972221146,103.76396027777982,BUKIT PANJANG,7086,181035,-173949,94060,0.011218393107713153,764
44651,1.38533394998016,103.76289650600476,BUKIT PANJANG,22479,77506,-55027,49992,0.005962469787803486,406
44611,1.3871248273065,103.76757814102818,BUKIT PANJANG,74065,106174,-32109,90119,0.010748356033106544,732
44701,1.38927144639115,103.76879686807085,BUKIT PANJANG,68598,66162,2436,67380,0.008036310095659284,547
44691,1.38826258050731,103.7714646491703,BUKIT PANJANG,195759,178779,16980,187269,0.022335288740041828,1522
44771,1.38458556236413,103.77079566381067,BUKIT PANJANG,146217,113903,32314,130060,0.015512058341369046,1057
44779,1.38422184036636,103.77020678944983,BUKIT PANJANG,93302,139594,-46292,116448,0.013888575809132268,946
44699,1.38805300466507,103.77154344868076,BUKIT PANJANG,133107,175169,-42062,154138,0.018383804771812565,1252
44709,1.3885418939603,103.76842967593706,BUKIT PANJANG,56259,54889,1370,55574,0.006628226435977575,451
44619,1.38695072395596,103.76763574907523,BUKIT PANJANG,81285,64871,16414,73078,0.008715901887364041,593
44659,1.38496763142496,103.76292100976569,BUKIT PANJANG,19615,10580,9035,15097,0.0018005962231250846,122
47009,1.437553,103.786282,WOODLANDS,525215,345723,179492,435469,0.017307308548165576,4415
46381,1.42907427878851,103.76676266569542,SUNGEI KADUT,11763,43654,-31891,27708,0.012390236093292557,4
45141,1.42484086207371,103.75684069951173,SUNGEI KADUT,324,178,146,251,0.00011224012052174216,0
49091,1.42753888899762,103.75641027798767,SUNGEI KADUT,45,1219,-1174,632,0.0002826125743814384,0
49101,1.43019265139167,103.75584633886155,SUNGEI KADUT,1052,22483,-21431,11767,0.0052618705106746615,1
49111,1.43245972200669,103.75543333298812,SUNGEI KADUT,607,29036,-28429,14821,0.006627533172321676,2
49121,1.43528737784327,103.75494271333446,SUNGEI KADUT,501,14141,-13640,7321,0.003273744710516631,1
49189,1.43646977071566,103.753734543128,SUNGEI KADUT,419,3914,-3495,2166,0.0009685741077692969,0
49179,1.43467967585537,103.75053324827904,SUNGEI KADUT,264,19280,-19016,9772,0.00436976277983452,1
49159,1.43707187354398,103.74581261172025,SUNGEI KADUT,910,21346,-20436,11128,0.004976127733728871,1
49149,1.43841910254735,103.74316251360837,SUNGEI KADUT,1115,30675,-29560,15895,0.007107795680052158,2
49199,1.4383674275063,103.73578447263064,LIM CHU KANG,9313,9171,142,9242,0.205131619833977,22
49141,1.4383065782824,103.74365393048626,SUNGEI KADUT,15922,636,15286,8279,0.003702135290037862,1
49151,1.43666749998525,103.74684027798631,SUNGEI KADUT,31197,220,30977,15708,0.007024174554404486,2
49089,1.43387888896839,103.74860194398363,SUNGEI KADUT,1634,1258,376,1446,0.0006466104154360127,0
45449,1.43188298917832,103.74760838738165,SUNGEI KADUT,5403,2927,2476,4165,0.001862470525789068,0
49079,1.42936840267626,103.74721764191128,SUNGEI KADUT,3101,5060,-1959,4080,0.0018244609232219444,0
49069,1.4264399252605,103.74887339054357,SUNGEI KADUT,9006,12883,-3877,10944,0.004893848123465922,1
49059,1.42318199210104,103.75019253254519,SUNGEI KADUT,8257,8929,-672,8593,0.0038425472336387667,1
49049,1.420040467845,103.75074630835057,SUNGEI KADUT,4402,3090,1312,3746,0.001675105543722893,0
49039,1.41665386559511,103.75136638264014,SUNGEI KADUT,7027,4524,2503,5775,0.0025824171155898845,0
49029,1.41359128228018,103.75189550271323,SUNGEI KADUT,16252,5926,10326,11089,0.004958688033727485,1
49019,1.41054305509663,103.75244718246053,SUNGEI KADUT,3228,1165,2063,2196,0.000981989261616517,0
49131,1.40812181907283,103.75361193086513,SUNGEI KADUT,2475,1071,1404,1773,0.0007928355923707126,0
45171,1.40600808717869,103.75535627770704,SUNGEI KADUT,3973,8121,-4148,6047,0.002704047843804681,1
45161,1.40273722420741,103.75467349450044,SUNGEI KADUT,1349,210,1139,779,0.0003483468282328173,0
45151,1.40086873669287,103.75428556537604,SUNGEI KADUT,1763,618,1145,1190,0.0005321344359397337,0
45159,1.40081444400002,103.75410111097352,SUNGEI KADUT,762,2031,-1269,1396,0.0006242518256906457,0
45169,1.40316333179329,103.75459594317567,SUNGEI KADUT,196,888,-692,542,0.0002423671128397779,0
45179,1.40606366967223,103.75520214111529,SUNGEI KADUT,6246,4147,2099,5196,0.002323504646338535,0
49139,1.40797195308481,103.7535208650928,SUNGEI KADUT,1124,3166,-2042,2145,0.0009591835000762427,0
49011,1.41051803168987,103.75228251770571,SUNGEI KADUT,1547,4266,-2719,2906,0.001299481236000728,0
49021,1.41337474993907,103.75177016684295,SUNGEI KADUT,4404,18347,-13943,11375,0.005086579167070985,1
49031,1.41631604671773,103.75124374338,SUNGEI KADUT,3113,6951,-3838,5032,0.0022501684719737312,0
49041,1.41926629646719,103.75071744712069,SUNGEI KADUT,2316,4885,-2569,3600,0.0016098184616664215,0
49051,1.42276696289419,103.75010170518756,SUNGEI KADUT,11834,16169,-4335,14001,0.006260852300497658,2
49061,1.42612604353693,103.74894489726996,SUNGEI KADUT,5413,4567,846,4990,0.002231387256587623,0
49071,1.42920936914454,103.74707415989546,SUNGEI KADUT,3739,3836,-97,3787,0.001693439587314094,0
45441,1.43189396450238,103.74745276475524,SUNGEI KADUT,3357,3460,-103,3408,0.0015239614770442124,0
49081,1.43392569720193,103.74846964367356,SUNGEI KADUT,1204,1350,-146,1277,0.0005710383820966723,0
49171,1.43471927034855,103.75086631663139,SUNGEI KADUT,15857,123,15734,7990,0.003572902641309641,1
49181,1.43689816677634,103.75406639623813,SUNGEI KADUT,7295,330,6965,3812,0.0017046188821867774,0
49129,1.43487511854102,103.75521112659418,SUNGEI KADUT,15111,463,14648,7787,0.003482126766943451,1
49119,1.43218727065725,103.75568435534463,SUNGEI KADUT,20479,425,20054,10452,0.00467383960037151,1
49109,1.42885154471804,103.75622617449282,SUNGEI KADUT,3945,910,3035,2427,0.0010852859462401124,0
49099,1.42763,103.7566,SUNGEI KADUT,3608,78,3530,1843,0.0008241376180142263,0
45149,1.4251485321405,103.75694671247683,SUNGEI KADUT,166,212,-46,189,8.451546923748712e-05,0
49219,1.43853758245996,103.73562300935441,LIM CHU KANG,46,1577,-1531,811,0.01800062147645048,1
49249,1.43705520733335,103.72546776099374,LIM CHU KANG,214,278,-64,246,0.0054601145292315885,0
49239,1.44057893181931,103.7279274650063,LIM CHU KANG,412,376,36,394,0.008745061481777422,0
49209,1.44513667520796,103.72983812848105,LIM CHU KANG,1340,976,364,1158,0.02570249034491943,2
49229,1.44030777799976,103.7321016670081,LIM CHU KANG,202,72,130,137,0.0030407954898566164,0
49211,1.43868741216241,103.7350959713107,LIM CHU KANG,1220,100,1120,660,0.014649087761353043,1
45221,1.41185472198007,103.75786055597196,SUNGEI KADUT,1908,1586,322,1747,0.0007812091257031218,0
45181,1.41163371804971,103.76126994848113,SUNGEI KADUT,50,246,-196,148,6.618142564628621e-05,0
45191,1.41064903489935,103.7634845917912,SUNGEI KADUT,94,2056,-1962,1075,0.00048070967952538974,0
45201,1.41047253271791,103.76582403754685,SUNGEI KADUT,415,5560,-5145,2987,0.0013357021513882225,0
45211,1.41031981199246,103.76978816795226,SUNGEI KADUT,2019,5353,-3334,3686,0.0016482752360284527,0
45209,1.4099988110322,103.76653377102565,SUNGEI KADUT,9664,1910,7754,5787,0.0025877831771287723,0
45199,1.41035479540467,103.76322407621203,SUNGEI KADUT,5970,120,5850,3045,0.0013616381154928482,0
45189,1.41134149901997,103.76099444217142,SUNGEI KADUT,112,44,68,78,3.4879400002772464e-05,0
45229,1.41157694400245,103.75794694401966,SUNGEI KADUT,1574,828,746,1201,0.0005370533256837145,0
40341,1.3546236109849,103.73889587967264,BUKIT BATOK,84624,105121,-20497,94872,0.007633614811748905,591
40301,1.35332581027753,103.74287381027882,BUKIT BATOK,19649,75959,-56310,47804,0.003846417514765628,298
40309,1.35367643079374,103.74299081028306,BUKIT BATOK,7564,420,7144,3992,0.0003212053116673163,24
43541,1.35283067935634,103.75505166565658,BUKIT BATOK,71677,51430,20247,61553,0.004952693023311202,383
43801,1.35520792569828,103.75173377561002,BUKIT BATOK,35679,42368,-6689,39023,0.0031398784762509224,243
43561,1.35745163479028,103.75287425796093,BUKIT BATOK,3527,7297,-3770,5412,0.0004354617101060911,33
43571,1.35920995233758,103.75150455211015,BUKIT BATOK,392512,305920,86592,349216,0.02809870594168675,2177
43841,1.3619538889938,103.74752277796905,BUKIT BATOK,84192,54780,29412,69486,0.005591000071772329,433
43659,1.36376864242438,103.74933550929673,BUKIT BATOK,58722,13087,45635,35904,0.002888916710947726,223
43589,1.36227296946091,103.75153180716009,BUKIT BATOK,83522,36189,47333,59855,0.004816068118699202,373
43579,1.35911715344895,103.75166771394562,BUKIT BATOK,315172,513773,-198601,414472,0.03334935068571541,2583
43569,1.35741203899294,103.75311063706323,BUKIT BATOK,3026,2274,752,2650,0.0002132249689174319,16
43809,1.35437129288657,103.7518708699386,BUKIT BATOK,36775,64981,-28206,50878,0.004093758478709849,317
43549,1.35254074739712,103.75549198596346,BUKIT BATOK,41473,60963,-19490,51218,0.0041211156445332174,319
43669,1.36548561348564,103.7461454769507,BUKIT BATOK,23965,32040,-8075,28002,0.002253103992311671,174
43681,1.36178500002853,103.74358000000312,BUKIT BATOK,31994,11292,20702,21643,0.001741444529162256,134
18329,1.2989244439988,103.77611416701255,QUEENSTOWN,14870,1514,13356,8192,0.000711414450328126,68
18319,1.29752638901257,103.77813111102236,QUEENSTOWN,11725,3747,7978,7736,0.0006718142319016581,64
18309,1.29752011664987,103.78134198615086,QUEENSTOWN,28028,7140,20888,17584,0.0015270400017785362,146
18239,1.29678943404486,103.78318782626637,QUEENSTOWN,1027,1584,-557,1305,0.00011332957247048394,10
18339,1.29379302903228,103.78507910002646,QUEENSTOWN,18207,40088,-21881,29147,0.002531200803676012,242
11259,1.31119887945564,103.79274002213417,QUEENSTOWN,8168,7430,738,7799,0.0006772853147105779,64
18331,1.2937072200211,103.78489139998855,QUEENSTOWN,48435,16405,32030,32420,0.0028154365819870416,270
18221,1.29630067771211,103.78346553393848,QUEENSTOWN,633,1835,-1202,1234,0.00010716374898741547,10
18301,1.29738521493261,103.7809269856724,QUEENSTOWN,7374,24799,-17425,16086,0.001396949810544218,134
18311,1.29743814797617,103.77792133383952,QUEENSTOWN,3113,10767,-7654,6940,0.0006026875348238762,57
18321,1.29879333297449,103.77561916702605,QUEENSTOWN,2591,11341,-8750,6966,0.0006049454420148591,58
47571,1.43349024051919,103.79639715585557,WOODLANDS,55604,45734,9870,50669,0.0020137920651688217,513
47561,1.43320820124698,103.79885163626874,WOODLANDS,49638,52501,-2863,51069,0.002029689691450523,517
47569,1.43291945534759,103.7987803897484,WOODLANDS,44455,28719,15736,36587,0.0014541161319215235,370
47579,1.4333134741952,103.79597019770507,WOODLANDS,47070,45640,1430,46355,0.0018423361657206718,470
47601,1.44211880036977,103.80304911976373,WOODLANDS,86872,49822,37050,68347,0.002716387658688615,693
47611,1.44388706173517,103.80622284389754,WOODLANDS,106294,158415,-52121,132354,0.00526028607222077,1342
58359,1.45619440004203,103.81465411421149,SEMBAWANG,33715,204176,-170461,118945,0.01568554585092949,1609
58459,1.45994030687762,103.81514063371951,SEMBAWANG,848,21388,-20540,11118,0.0014661557759521968,150
58369,1.46077451756536,103.81206144667213,SEMBAWANG,33074,42177,-9103,37625,0.004961693746195485,509
58361,1.46118688481447,103.81270708997143,SEMBAWANG,121295,114821,6474,118058,0.015568575157165358,1597
58451,1.46002660309429,103.81537241523831,SEMBAWANG,20496,536,19960,10516,0.0013867686760130691,142
58351,1.45593548683251,103.81491062256012,SEMBAWANG,200371,9172,191199,104771,0.013816388451366039,1418
47619,1.44430697551185,103.80713784459924,WOODLANDS,281681,185288,96393,233484,0.009279603436891928,2367
47609,1.44184941782685,103.80309468577371,WOODLANDS,21136,84990,-63854,53063,0.0021089393584648045,538
46801,1.44651205748064,103.79756626316295,WOODLANDS,19968,97759,-77791,58863,0.0023394549395494746,596
46881,1.44983018145906,103.80523207218322,SEMBAWANG,24024,78426,-54402,51225,0.00675515646907279,693
46891,1.44823908984273,103.80703539255815,SEMBAWANG,16952,15057,1895,16004,0.002110483633597676,216
46901,1.4479841829065,103.80951476110357,SEMBAWANG,35852,31767,4085,33809,0.004458469205717559,457
46911,1.45068968281344,103.81027103832493,SEMBAWANG,59206,55836,3370,57521,0.007585424211957755,778
46921,1.4533158942724,103.81089004960499,SEMBAWANG,96361,102755,-6394,99558,0.013128938365016083,1347
46931,1.45305389773625,103.80789928421208,SEMBAWANG,70246,43295,26951,56770,0.007486388145422397,768
46941,1.45167306508663,103.80547695607456,SEMBAWANG,48738,8987,39751,28862,0.0038060971402709394,390
46809,1.44649662319346,103.79808713932866,WOODLANDS,74657,25832,48825,50244,0.0019969008372445135,509
58301,1.44485650594175,103.81055057568135,SEMBAWANG,49407,50622,-1215,50014,0.006595459163381289,676
58581,1.443876,103.813122,SEMBAWANG,30393,25944,4449,28168,0.0037145777925005827,381
58571,1.441805,103.8168685,SEMBAWANG,23118,11669,11449,17393,0.002293654201397424,235
59279,1.43670438744279,103.8288049642525,YISHUN,20382,23446,-3064,21914,0.0010990061952875934,243
59269,1.43774971409693,103.8312528105951,YISHUN,29418,19787,9631,24602,0.0012338117375406304,273
58579,1.4415255,103.817029,MANDAI,6655,25293,-18638,15974,0.048337070423728555,101
58589,1.443534,103.813173,MANDAI,24239,28149,-3910,26194,0.07926262818825253,165
58309,1.44466063592056,103.81036650514453,WOODLANDS,46170,56130,-9960,51150,0.0020329089607725673,518
44371,1.37402225721945,103.77263963002856,BUKIT PANJANG,29625,34091,-4466,31858,0.0037996551948280416,258
44381,1.37242134216992,103.77441361028244,BUKIT PANJANG,42244,60369,-18125,51306,0.006119188568831926,417
44351,1.36823452426378,103.77558853634072,BUKIT PANJANG,49808,43658,6150,46733,0.005573773815678915,379
44361,1.36645894982356,103.77558768232717,BUKIT PANJANG,13641,11769,1872,12705,0.001515306022044393,103
44369,1.36574284265165,103.7753149073364,BUKIT PANJANG,11923,13709,-1786,12816,0.0015285448231814986,104
44359,1.36772582083696,103.77530877476855,BUKIT PANJANG,27874,36867,-8993,32370,0.0038607206559289255,263
44389,1.37154303506556,103.77461859337586,BUKIT PANJANG,31075,37638,-6563,34356,0.004097587854652276,279
44379,1.37355053515267,103.77293526626733,BUKIT PANJANG,16849,32876,-16027,24862,0.002965252917754246,202
44199,1.37888221944077,103.76672499902976,BUKIT PANJANG,4541,2653,1888,3597,0.0004290087179294515,29
43229,1.34904928626369,103.76096016466906,BUKIT BATOK,19171,15688,3483,17429,0.0014023765974573285,108
43221,1.34885995836966,103.76067444562183,BUKIT BATOK,23667,37353,-13686,30510,0.0024549033213852253,190
44191,1.37879277619241,103.76702648572689,BUKIT PANJANG,743,5742,-4999,3242,0.0003866684079864559,26
44811,1.38715472588861,103.76020832276009,BUKIT PANJANG,56046,42553,13493,49299,0.00587981673205561,400
43969,1.36463,103.7725931,BUKIT PANJANG,17125,17568,-443,17346,0.0020688310317498655,140
43899,1.363535,103.769,BUKIT PANJANG,391,1856,-1465,1123,0.0001339385015943214,9
42991,1.36164,103.766952,BUKIT BATOK,49481,11674,37807,30577,0.0024602942922974775,190
43891,1.363698889,103.7692319,BUKIT PANJANG,3484,1234,2250,2359,0.0002813543412831738,19
43961,1.364838889,103.7729861,BUKIT PANJANG,13183,27224,-14041,20203,0.002409581075431946,164
44949,1.388429,103.742903,CHOA CHU KANG,9170,10367,-1197,9768,0.0008254817634278113,158
44941,1.388198,103.744284,CHOA CHU KANG,6314,2346,3968,4330,0.00036592301757191066,70
31081,1.38056264189347,103.69732526991169,WESTERN WATER CATCHMENT,45,594,-549,319,0.00022421824096221255,0
34101,1.38440683002823,103.69790380001842,WESTERN WATER CATCHMENT,85,3539,-3454,1812,0.0012736158389452324,0
32101,1.38541382998394,103.69744470002844,WESTERN WATER CATCHMENT,31,176,-145,103,7.239648532635703e-05,0
32111,1.39837200000575,103.69964580001103,WESTERN WATER CATCHMENT,15,4340,-4325,2177,0.0015301664908298957,0
32031,1.40270299424992,103.70078174769526,WESTERN WATER CATCHMENT,19,2941,-2922,1480,0.001040260177504936,0
32041,1.40436104392726,103.70166157203701,WESTERN WATER CATCHMENT,4,82,-78,43,3.0223775427508274e-05,0
32051,1.40929365504034,103.70097942080086,WESTERN WATER CATCHMENT,0,39,-39,19,1.3354691467968773e-05,0
32061,1.41146307596912,103.70006004261607,WESTERN WATER CATCHMENT,0,26,-26,13,9.137420478083898e-06,0
32071,1.4160246040166,103.70056776202736,WESTERN WATER CATCHMENT,10,915,-905,462,0.0003247298662211354,0
32081,1.41744631606558,103.70120361125713,WESTERN WATER CATCHMENT,311,15856,-15545,8083,0.005681366901873241,1
33011,1.41959108645842,103.70222963088568,LIM CHU KANG,112,544,-432,328,0.007280152705642118,0
33021,1.42179012512071,103.70324459408172,LIM CHU KANG,12,1265,-1253,638,0.014160784835974608,1
33031,1.42397958326967,103.70422572285418,LIM CHU KANG,38,2055,-2017,1046,0.023216584542992854,2
33041,1.42761911626678,103.70594344849181,LIM CHU KANG,157,4206,-4049,2181,0.048408576375016645,5
33051,1.43024937289974,103.70683437257524,LIM CHU KANG,9,290,-281,149,0.0033071425400630354,0
34011,1.43318199595331,103.7078231906078,LIM CHU KANG,69,893,-824,481,0.01067607759577396,1
34021,1.43518649812518,103.70804760933633,LIM CHU KANG,4,2262,-2258,1133,0.02514760065698939,2
34031,1.4376660533385,103.70795650853267,LIM CHU KANG,31,1781,-1750,906,0.020109202290584632,2
34041,1.43886508618445,103.70790669860943,LIM CHU KANG,12,889,-877,450,0.00998801438274071,1
34051,1.4427555864767,103.70775406469974,LIM CHU KANG,68,2991,-2923,1529,0.033937053313801216,3
34009,1.44482656088302,103.70756734461297,LIM CHU KANG,3900,4420,-520,4160,0.09233364407155857,10
34059,1.44234338763128,103.7078689605441,LIM CHU KANG,3244,60,3184,1652,0.03666711057841701,4
34049,1.43837406233239,103.70802408979871,LIM CHU KANG,1156,22,1134,589,0.013073201047631731,1
34039,1.43659170251147,103.70811753153625,LIM CHU KANG,1841,63,1778,952,0.021130199316375903,2
34029,1.43497194397025,103.70818333298028,LIM CHU KANG,1366,19,1347,692,0.015359346561903494,1
34019,1.43253416698475,103.70773805599093,LIM CHU KANG,1123,39,1084,581,0.012895636347494119,1
33059,1.42935991121752,103.70662973279376,LIM CHU KANG,280,16,264,148,0.003284946952545834,0
33049,1.42621743469097,103.70543799603165,LIM CHU KANG,4616,190,4426,2403,0.0533359968038354,5
33039,1.42329599233546,103.70408030420536,LIM CHU KANG,1204,19,1185,611,0.013561503973010166,1
33029,1.42080314827393,103.70292186217569,LIM CHU KANG,1387,15,1372,701,0.015559106849558307,1
33019,1.41920159190274,103.70215656491881,LIM CHU KANG,4378,58,4320,2218,0.0492298131131531,5
32089,1.41681891211204,103.7010851003633,LIM CHU KANG,17676,40,17636,8858,0.1966085142273716,21
32079,1.41512827700833,103.70026822968337,WESTERN WATER CATCHMENT,287,5,282,146,0.00010262026075386531,0
32069,1.41103257931936,103.7003812106999,WESTERN WATER CATCHMENT,24,7,17,15,1.0543177474712188e-05,0
32059,1.40903140804682,103.70120779053055,WESTERN WATER CATCHMENT,23,5,18,14,9.840298976398042e-06,0
32049,1.40452254375654,103.70187031633597,WESTERN WATER CATCHMENT,50,0,50,25,1.7571962457853648e-05,0
32039,1.40251788786303,103.70081478116067,WESTERN WATER CATCHMENT,1673,27,1646,850,0.0005974467235670241,0
32119,1.39858000001944,103.699882699978,WESTERN WATER CATCHMENT,4168,17,4151,2092,0.0014704218184731933,0
32109,1.3857176700282,103.69770270003046,WESTERN WATER CATCHMENT,118,26,92,72,5.0607251878618506e-05,0
34109,1.38430083002772,103.69811219997105,WESTERN WATER CATCHMENT,3004,76,2928,1540,0.0010824328874037847,0
31089,1.37992729418245,103.69711516294915,WESTERN WATER CATCHMENT,651,0,651,325,0.00022843551195209742,0
44519,1.3791475870641,103.73970664823418,CHOA CHU KANG,83099,5241,77858,44170,0.0037327528143536472,716
44529,1.38057038161005,103.7417695571546,CHOA CHU KANG,27323,2250,25073,14786,0.0012495468216670372,240
44839,1.38855,103.7662,BUKIT PANJANG,11955,23770,-11815,17862,0.0021303735667656,145
44919,1.385493611,103.7727914,BUKIT PANJANG,11257,7447,3810,9352,0.0011153988129208314,76
44929,1.3827025,103.7730945,BUKIT PANJANG,4654,4894,-240,4774,0.0005693877173742568,38
44921,1.3822735,103.772836,BUKIT PANJANG,1692,1832,-140,1762,0.00021015105949171353,14
44911,1.3848475,103.772859,BUKIT PANJANG,8554,15518,-6964,12036,0.0014355154097856209,97
44831,1.387891389,103.7657931,BUKIT PANJANG,5590,8693,-3103,7141,0.0008516962064871318,58
45491,1.39414432388749,103.75296269916254,SUNGEI KADUT,3030,26531,-23501,14780,0.006609199128730475,2
45469,1.39231423792189,103.74449399998608,CHOA CHU KANG,58397,68912,-10515,63654,0.005379321884647206,1033
45461,1.39267723795995,103.74330600001463,CHOA CHU KANG,68241,42489,25752,55365,0.004678828606898114,898
45489,1.3937917601606,103.75199938008781,CHOA CHU KANG,27528,6169,21359,16848,0.001423803926108903,273
44031,1.37785685552262,103.76232373807855,BUKIT BATOK,251031,577204,-326173,414117,0.03332078658610571,2581
21069,1.31237305598007,103.7191852779968,JURONG EAST,40748,62427,-21679,51587,0.005031086000488997,395
21109,1.31100299869144,103.72109770773132,JURONG EAST,34058,40152,-6094,37105,0.003618711032782372,284
21089,1.31206487520147,103.72296452520035,JURONG EAST,35586,43331,-7745,39458,0.0038481902690075953,302
21139,1.31433044660166,103.71846563037732,JURONG EAST,357,2099,-1742,1228,0.00011976221933046092,9
21129,1.31427443753325,103.71493141053244,JURONG EAST,1014,8965,-7951,4989,0.00048655839758930745,38
21119,1.31397291780129,103.71201936489673,JURONG EAST,397,2318,-1921,1357,0.00013234310393439371,10
21099,1.31014377264327,103.71110346092364,JURONG EAST,10359,9871,488,10115,0.000986477889680466,77
21111,1.31442640542243,103.71238327744312,BOON LAY,3485,205,3280,1845,0.0024612700153279093,0
21121,1.31469130993085,103.71601687480324,BOON LAY,13506,1385,12121,7445,0.009931791471065737,0
21131,1.31470833302608,103.71799361097378,BOON LAY,1162,194,968,678,0.0009044667048196869,0
58421,1.4513061244853,103.81902919989243,SEMBAWANG,16763,640,16123,8701,0.00114742052586437,117
58429,1.45151629026328,103.81892529028816,SEMBAWANG,356,15866,-15510,8111,0.0010696158930336634,109
47121,1.46371324914732,103.80278498662895,SEMBAWANG,1780,3681,-1901,2730,0.00036001126716581197,36
47131,1.46664224303828,103.80222436305644,SEMBAWANG,1258,3237,-1979,2247,0.0002963169660518606,30
47141,1.46756958848835,103.80367776966509,SEMBAWANG,2426,5143,-2717,3784,0.0004990046281888031,51
47151,1.46627333237122,103.80397260190183,SEMBAWANG,4128,5210,-1082,4669,0.0006157115774348631,63
47129,1.46369329324947,103.8029823843495,SEMBAWANG,847,1688,-841,1267,0.00016708215219746658,17
47169,1.46092504799029,103.80059733131966,SEMBAWANG,7044,8352,-1308,7698,0.0010151526500521686,104
47179,1.45828424831176,103.79880737870576,SEMBAWANG,4339,3281,1058,3810,0.0005024333069237155,51
47189,1.45900316740952,103.80129287195832,SEMBAWANG,728,540,188,634,8.360701222825083e-05,8
47199,1.46123583610566,103.80266128022876,SEMBAWANG,414,351,63,382,5.0375202951406655e-05,5
44589,1.37512566998176,103.7401815256426,CHOA CHU KANG,48541,44623,3918,46582,0.003936587991809409,756
44559,1.37620955732727,103.73789066346548,CHOA CHU KANG,106038,59721,46317,82879,0.007004003180910481,1345
44879,1.37431656227768,103.74701128990601,CHOA CHU KANG,81825,60403,21422,71114,0.006009757383743384,1154
44899,1.37432287109092,103.74949989571633,CHOA CHU KANG,18847,27777,-8930,23312,0.001970068680285538,378
44891,1.37409009466488,103.74930160167106,CHOA CHU KANG,20889,20002,887,20445,0.001727782007911712,331
44871,1.37415475892549,103.74679713839167,CHOA CHU KANG,58825,90987,-32162,74906,0.0063302146776539345,1215
44599,1.37551323792473,103.7421877620434,CHOA CHU KANG,27608,52466,-24858,40037,0.003383478026449558,649
21711,1.34699884210956,103.7157628162222,JURONG WEST,14782,20127,-5345,17454,0.0007170540589495343,93
27501,1.34097116721964,103.69167107077278,JURONG WEST,26559,15931,10628,21245,0.0008727978390273207,114
27511,1.33925202251324,103.69310573763543,JURONG WEST,9888,19469,-9581,14678,0.0006030090224167105,78
27521,1.3368089664846,103.69406174421559,JURONG WEST,6215,31770,-25555,18992,0.0007802389531092904,102
27529,1.33629804819426,103.69406295180332,JURONG WEST,20742,6158,14584,13450,0.000552559705103199,72
27519,1.34004285535929,103.69292404819555,JURONG WEST,13849,25458,-11609,19653,0.0008073944895459606,105
27509,1.34043647212319,103.69135819975955,JURONG WEST,5810,19443,-13633,12626,0.0005187077201957614,67
27149,1.33906525108364,103.68875795867145,JURONG WEST,75752,21460,54292,48606,0.0019968562844792635,261
27539,1.34071614464901,103.6868923374865,JURONG WEST,38711,23929,14782,31320,0.0012867040865302748,168
27139,1.34202746082141,103.68898154351334,JURONG WEST,50863,14600,36263,32731,0.001344671502433666,175
27349,1.34680805601666,103.69781805598312,JURONG WEST,60513,52175,8338,56344,0.0023147527155639143,302
21719,1.34779474567713,103.71507297402223,JURONG WEST,14014,3555,10459,8784,0.000360868732314238,47
28201,1.33205706208933,103.7418504873348,JURONG EAST,17554,1793,15761,9673,0.0009433712928204793,74
43331,1.34893916700858,103.74323444400876,BUKIT BATOK,74665,86523,-11858,80594,0.0064847747716722665,502
40371,1.35813308018627,103.74305344718294,BUKIT BATOK,47612,13682,33930,30647,0.0024659266499669945,191
43601,1.35664340859556,103.74950528201234,BUKIT BATOK,11189,33910,-22721,22549,0.001814343329856291,140
30129,1.37203889001441,103.74381033081468,TENGAH,1426,72301,-70875,36863,0.20046877379217332,2
30119,1.37288750001555,103.7404039307868,TENGAH,53,2416,-2363,1234,0.006710752430880338,0
30109,1.373745,103.738354,TENGAH,664,22903,-22239,11783,0.06407844075612887,0
44881,1.37573320756145,103.74842003077862,CHOA CHU KANG,12717,17158,-4441,14937,0.0012623076474530322,242
44889,1.3755999743303,103.74839851286828,CHOA CHU KANG,13350,18390,-5040,15870,0.0013411543392300744,257
30101,1.373713,103.738897,CHOA CHU KANG,35600,2265,33335,18932,0.0015999202237116424,307
30111,1.37245788679333,103.74282538457524,CHOA CHU KANG,26995,2783,24212,14889,0.0012582512260111264,241
30121,1.37211783027051,103.74443713836388,CHOA CHU KANG,78268,5222,73046,41745,0.0035278190227573695,677
43609,1.35653561927142,103.74992425404375,BUKIT BATOK,31652,16974,14678,24313,0.001956278743128121,151
40379,1.35754268986546,103.74357270089524,BUKIT BATOK,15067,64676,-49609,39871,0.0032081104663045008,248
40369,1.3576342194572,103.74139552039492,BUKIT BATOK,27195,73775,-46580,50485,0.0040621368135081316,314
40349,1.35497444398167,103.73939913984925,BUKIT BATOK,49673,73466,-23793,61569,0.004953980419349949,383
43339,1.34907250002611,103.74377833982919,BUKIT BATOK,58067,47602,10465,52834,0.0042511426444466404,329
